а	ю
абад	о,р
абадий	сф
абадийлашмоқ	ф
абадийлаштирмоқ	ф
абадийлик	о
абадия	о
абадиян	р
абадият	о
абадулабад	р
абажур	о
абажурли	сф
абас	сф
аббат	о
аббосийлар	о
аббревиатура	о
абгор	сф
абгорлик	о
абдол	о
абдолваш	сф
аберрацион	сф
аберрация	о
абёт	о
абжад	о
абжадхон	о
абжадхнонлик	о
абжақ	ф
абжақламоқ	ф
абжир	сф
абжирлик	о
абжўш	о,сф
абжўши	сф
абзал	о
абзалламоқ	ф
абзац	о
абира	о
абитуриент	о
аблақ	c
аблаҳ	c
аблаҳлик	о
аблаҳона	сф
або	о
аболиция	о
абонемент	о
абонент	о
абориген	сф	
аборигенлар	о
аборт	ф
абортив	сф
абр	о
абразив	сф
абразивлар	о
абраш	о
абрбанд	ф
абрбанди	о
абрбандчи	о
абришим		о
абрў	о
абрўкамон	сф
абсетеизм	о
абсолют	сф
абсолютизм	о
абсорбция	о
абстракт	сф
абстракционизм	о
абстракционист	о
абстракция	о
абсцесс	о
абу	о
абхаз	о
абхазлар	о
авайламоқ	ф
авангард	о
авангардизм	о
аванпост	о
аванс	о
авантюра	о
авантюризм	о
авантюрист	о
авантюристик	сф
авар	о
авара	о
авария	о
авариячи	о
аваралар	о
авахта	о
аваға	о
авбош	о
аввал	о,р,к
авваламбор	р
аввалан	р
аввалбоши	р
аввалги	сф
аввалгидай	р
аввалгича	р
аввали	о,р
аввалига	р
аввало	р
август	о
авж	ф,о
авжи	о,р
авжида	р
авжланмоқ	ф
авзо	о
авиа	сф
авиакомпания	о
авиакомпас	о
авиалиния	о
авиамоделчи	о
авиамоделчилик	о
авиамодель	о
авианосец	о
авиапочта	о
авиасалон	о
авиатор	о
авиатрасса	о
авиация	о
авизо	о
авитаминозлар	о
авлиё	о
авлиёнамо	сф
авлиёуллоҳ	о
авло	сф
авлод	о
авлоқ	сф
авом	о
авоқ	о
авра	о
авра-астар	о
аврабанд	сф
аврамоқ	ф
аврат	о
авратпўш	о
аврағич	о
аврод	о
авродчи	о
аврон	о
авроқ	о
авроқчи	о
авсат	
автаркия	о
авто	о
авто-	сф
автобаза	о
автобиографик	сф
автобиография	о
автоблокировка	о
автобус	о
автовокзал	о
автоген	сф
автограф	о
автодром	о
автодўкон	о
автозавод	о
автоинспекция	о
автокар	о
автокачка	о
автоклав	о
автоколонна	о
автокорхона	о
автокран	о
автол	о
автолавка	о
автомагистраль	о
автомат	о
автоматизм	о
автоматик	р,сф
автоматика	о
автоматлашмоқ	ф
автоматлаштирмоқ	ф
автомат-справочник	о
автомат-телефон	о
автоматчи	о
автомашина	о
автомобилсоз	о
автомобилсозлик	о
автомобиль	о
автоназорат	о
автоном	сф
автономия	о
автономияли	сф
автономиячи	о
автопарк	о
автопилот	о
автопоилка	о
автопойга	о
автопортрет	о
автопрцеп	о
автор	о
авторалли	о
авторемонт	сф
автореферат	о
авторитар	сф,о
авторитаризм	о
авторлик	о
авторучка	о
автосалон	о
автосарой	о
автостанция	о
автостоп	о
автострада	о
автосуғоргич	о
автотранспорт	о
автоуй	о
агар	ю
агарда	ю
агглютинатив	c
агглютинация	о
агент	о
агентлик	о
агентура	о
агитатор	о
агитацион	сф
агитация	о
агломерация	о
агнозия	о
агностик	о,сф
агностицизм	о
агония	о
аграр	сф
агрегат	о
агреман	о
агрессив	сф
агрессивлик	о
агрессия	о
агрессиячи	о
агрессиячилик	о
агрессор	о
агрессорлик	о
арго-	о
агробиологик	сф
агробиология	о
агрокимё	о
агромелиорация	о
агрометеорология	о
агроном	о
агрономик	сф
агрономия	о
агрономлик	о
агросаноат	о
агротехник	о,сф
агротехника	о
агрофизика	о
ада	о
адаси	о
адаб	о
абадиёт	о
адабиётчи	о
абадиётшунос	о
адабиётшунослик	о
адабий	сф
адабли	сф
адабсиз	сф
адабсизлик	о
адад	сф
ададсиз	сф
адам	о
адаптация	о
адаш	о,р
адашмоқ	ф
адаштирмоқ	ф
адвокат	о
адвокатура	о
аддоий	о
адекват	о
аденоидлар	о
аденома	о
адёл	о
адиб	о
адиба	о
ади-бади	о
адиблик	о
адигей	о
адигейлар	о
адиз	о
адил	с
адинамия	о
адип	о
адипламоқ	о
адир	о
адл	о
адлия	о
администратор	о
администрация	о
адмирал	о
адно	с
адо	о
адоват	о
адойи	о
адолат	о
адолатли	с
адолатпарвар	с
адолатсиз	c
адолатсизлик	о
адоқ	о
адоқламоқ	ф
адоқсиз	с
адрамкаш	о
адрас	о
адрасбоф	о
адрасман	о
адрес	о
адресант	о
адресат	о
адресланмоқ	ф
адсорбция	о
аду	о
адув	о
адулиқ	о
адувлиқ	о
адъюнкт	о
адъюнктура	о
аюъютант	о
аё	у
аёв	о
аёвсиз	с,р
аёз	о
аёзламоқ	ф
аёзли	с
аёл	о
аёлманд	с
аён	с
аёнлашмоқ	ф
аёқ	о
аёқчи	о
ажаб	с
ажабланмоқ	ф
ажабо	у
ажабсинмоқ	ф
ажабтовур	с
ажал	о
ажам	о
ажамий	с
аждар	о
аждаргул	о
аждарнафс	с
аждаҳо	о
аждарҳо	о
аждод	о
ажз	о
ажи	о
ажи-ажи	о
ажиб	с
ажи-бужи	с
ажива	с
аживақа	с
ажиз	с
ажилламоқ	ф
ажин	о
ажина	о
ажиндор	с
ажиотаж	о
ажирвоқи	с
ажнабий	с
ажойиб	с
ажойибот	о
ажойибхона	о
ажр	о
ажралиш	ф
ажралишмоқ	ф
ажралмас	с
ажралмоқ	ф
ажралувчан	с
ажрамачилик	о
ажрамоқ	ф
ажратма	о
ажратмоқ	ф
ажрашмоқ	ф
ажрим	о
ажриқ	о
ажриқзор	о
ажува	с
ажуз	о
ажуза	о
ажуз-мажуз	с
аза	о
азавозлик	о
азадор	о
азайимхон	о
азайимхонлик	о
азал	о
азалги	с
азалда	о
азалдан	р
азали	с,р
азалий	с
азалик	о
азамат	с,о
азахона	о
азбаройи	ю
азза-базза	р
азиз	c,о
азиз-авлиё	о	
азизламоқ	ф
азим	с,о
азимат	о
азимкор	с
азимут	о
азият	о
азиятли	с
азиятсиз	с
азл	о
азм	о
азмкор	c
азмойиш	о
азоб	о
азобламоқ	ф
азобли	с
азоб-уқубат	о
азозил	о
азон	о
азонда	р
азонлаб		р
азончи	о
азот	о
азотламоқ	ф
азотли	с
азроил	о
азтаҳидил	р
ай	у
айб	о
айбаки	с
айбдор	о
айбламоқ	с
айбланувчи	ф
айбли	с
айблов	ф,о
айбловчи	ф	
айбнома	о
айбона	о
айбситмоқ	ф
айвон	о
айём	о
айёр	с,о
айёрлик	о
айёрона	р
айил	о
айирбош	о
айирбошламоқ	ф
айирбошлаш	ф
айиргич	о
айириш	ф
айирма	о
айирмачи	о
айирмачилик	о
айирмоқ	ф
айирув	ф
айиқ	о
айиқмурут	о
айиқтовондошлар	о
айиқтовонлар	о
айламоқ	ф
айлана	о,с
айланай	у
айланасида	к
айланиб-ўргилмоқ	ф
айланиш	ф,о
айланишмоқ	ф
айланма	с,о
айланмачоқ	с,о
айланмоқ	ф
айлансин	ф
айлантирмоқ	ф
аймашмоқ	ф
аймоқ	о,ф
аймоқи	с
айнама	о
айнамачи	о
айнамоқ	ф
айнан	р
айни	ол,ю
айнимачи	с
айнимоқ	ф
айният	о
айниқса	м
айрам	о
айри	с,о
айрибош	о
айрилик	о
айрилиш	о,ф
айрилиқ	о	
айрилмас	с
айрилмоқ	ф
айрилувчи	ф
айрим	с
айрича	р
айро	р
айролиқ	о
айрон	о
айру	м
айсберг	о
айтайлик	ф
айтарли	c	
айтгандай	р
айтгандек	р
айтганча	р
айтилиш	ф
айтим	о
айтишмоқ	ф
айтишув	ф
айтмоқ	ф
айтмоқчи	ф
айттирмоқ	ф
айтувли	c
айш	о
айшгоҳ	о
айш-ишрат	о
айюҳаннос	у,о
айқашмоқ	ф
айқаш-уйқаш	с
айқин	с
айқирмоқ	ф
айғиз	о
айғир	о
айғоқ	о
айғоқламоқ	ф
айғоқчи	о
айғоқчилик	о
айҳай	у
айҳайламоқ	ф
ака	о
академизм	о
академик	о,с
академия	о
ак-ак	т
акапелла	о
акас	о
акация	о
акашак	о
акашакланмоқ	ф
акбар	с,о
акваланг	о
акванавт	о
акварель	о
аквариум	о
акватория	о
акведук	о
акилдоқ	с
акилламоқ	ф
акинезия	о
акклиматизация	о
аккомодация	о
аккорд	о
аккорд	с
аккордеон	о
аккордеончи	о
аккредитация	о
аккредитив	о
аккумулятор	о
акобир	о
акробат	о
акробатик	с
акробатика	о
акробатчи	о
акс	о,с
акса	о
аксар	о
аксари	о,р
аксарият	о
аксига	р
аксилинқилоб	о
аксилинқилобий	с
аксилинқилобчи	о
аксилҳаракат	о
аксилҳаракатчи	о
аксинча	р
аксиома	о
аксириш	ф
аксирмоқ	ф
аксича	р
аксланмоқ	ф
акслик	о
акт	о
актёр	о
актёрлик	о
актив	с
активлашмоқ	ф
актиний	о
актриса	о
актуал	с
актуарий	о
акула	о
акустик	о,с
акустика	о
акушер-гинеколог	о
акушерка	о
акушерлик	о
акцент	о
акциз	о
акционер	о
акционерлик	о
акция	о
акциядор	о
акциядорлик	о
алай-балай	о
алайкум	о
алайно	с
алайҳ	о
алайҳиллаъна	о
алайҳиссалом	о
алак	о
алалабад	р
алалоқибат	р
алалхусус	м
алам	о
аламангиз	с
алам-аччиқ	о
аламдийда	с
аламдор	о
аламзада	о
алам-изтироб	о
аламланмоқ	ф
аламли	с
аламнок	с
аламон	о
алам-ситам	о
аланга	о
алангаланмоқ	ф
алангали	с
аланг-жаланг	р
алангламоқ	ф
алапи	о
алас-алас	о
аласламоқ	ф
алаф	о
алахсимоқ	ф
алача	о
алачабоф	о
алақ-чалақ	с
алағ	с
алағда	с
алаҳламоқ	ф
алаҳлаш	ф
алағсирамоқ	ф
албан	о
албанлар	о
албат	м
албатта	м
алвасти	о
алвидо	у
алвир-шалвир	с
алвон	с
алвон-алвон	с
алгебра	о
алгебраик	с
алгоритм	о
алгорифм	о
алдаб-сулдаб	р
алдамоқ	ф
алдамчи	с
алдамчилик	о
алдам-қалдам	с
алдоқчи	о
алдоқчилик	о
алебастр	о
алеут	о
алеутлар	о
алё	у
алёр	о
алёрчи	о
алжимоқ	ф
алжирамоқ	ф
али	о
алиби	о
ализарин	о
алик	о
алимент	о
алиф	о
алифбе	о
алифбо	о
алифламоқ	ф
алифмой	о
алиш	о
алишинмоқ	ф
алишмоқ	ф
алкалоид	о
алкалоидлар	о
алкаш	о
алкимё	о
алкоголизм	о
алкоголик	о
алкоголь	о
алла	о
аллавақт	р
аллаким		ол
аллаламоқ	ф
алламаҳал	р
алланарса	о
алланеча	ол
алланечук	с
алланима	ол
алла-палла	р
аллақайси	ол
аллақандай	ол
аллақанча	ол
аллақачон	р
аллегорик	с
аллегория	о
аллерген	о
аллергик	с
аллергия	о
аллергологик	с
аллергология	о
аллигатор	о
аллитерация	о
алло	у
аллома	о
аллоф	о
аллоҳ	о
алманах	о
алмашинмоқ	ф
алмашинув	ф
алмашламоқ	ф
алмашмоқ	ф
алмаштирмоқ	ф
алмисоқ	ф
алмисоқи	с
алмойи-алжойи	с
ало	р
алой	о
аломат	о,с
алоэ	о
алоқа	о
алоқадор	с
алоқадриҳол	р
алоқали	с
алоқачи	о
алоқ-чалоқ	с
алоҳа	р
алоҳал	р
алоҳида	с
алоҳида-алоҳида	с,р
алоҳол	р
алп	о
алпанг-талпанг	р
алпи-салпи	р
алпозда	р
алпон-талпон	р
алфавит	о
алфоз	о
алфозда	р
алъамон	у
альбатрос	о
альбом	о
альпинизм	о
альпинист	о
альт	о
альтернатив	с
альтернатива	о
альтиметр	о
альтчи	о
альфа	о
альфа-зарралар	о
альма-терапия	о
альянс	о
алюмин	о
алюминий	о
алқамоқ	ф
алқандоз	о
алқисса	м
алқор	о
алғов	о
алғов-далғов	о
алҳазар	м
алҳамдулилло	м
алҳамдулиллоҳ	р
алҳол	м
алҳосил	м
амаки	о
амакивачча	о
амал	о
амалда	о
амалдор	о
амалиёт	о
амалиётчи	о
амалий	о,с
амалия	о
амаллаб	р
амалламоқ	ф
амалпараст	о
амалпарастлик	о
амал-тақал	о
амальгама	о
амбразура	о
амбулатория	о
амвол	о
аметропия	о
амёбалар	о
амин	с,о
аминона	о	
амир	о
амиралмўминин	о
амирзода	о
амири	о
амиркон	о
амирлик	о
амлок	о
амлокдор	о
амма	о
аммавачча	о
аммиак	о
аммиакли	с
аммо		б
аммо-лекин	ю
аммоний	о
аммофос	о
амнистия	о	
амният	о
амома	о
амортизатор	о
амортизация	о
аморф	с
ампер	о
амперли	с
амперметр	о
ампер-соат	о
амплитуда	о
амплуа	о
ампула	о
ампутация	о
амр	о
амримаъруф	о
амримаҳол	о
амфибия	о
амфибиялар	о
амфитеатр	о
амфора	о
ана	ол,ю
анабиоз	о
анави	ол
анакондалар	о
анализ	о
анализатор	о
анализаторлар	о
аналитик	с
аналогик	с
аналогия	о
ана-мана	о
ананас	о
анархизм	о
анархист	о
анархистик	с
анархистлик	о
анархия	о
анархиячи	о
анатом	о
анатомик	с
анатомия	о
анафора	о
анбар	о
анбарафшон	о
анбиё	о
анбуҳ	с
анвар	о
анво	о,с
анвои	о,с
анг-анг	о
ангар	о
ангидрид	о
ангилламоқ	ф
ангина	о
ангиома	о
ангишвона	о
англамоқ	ф
англатмоқ	ф
англашиларли	с
англашилмас	ф
англашилмовчилик	о
англашилмоқ	ф
ангор	о
анграймоқ	ф
ангров	c
анда	о
андава	о
андаваламоқ	ф
андаза	о
андазасиз	с
андак	р
андалиб	о
андармон	ф
анди	о
андиз	с
андиша	о
андишали	с
андишасиз	с
андоза	о
андом	о
андуҳ	о
анемия	о
анемометр	о
анероид	о
анестезия	о
анжир	о
анжирзор	о
анжом	о
анжуман	о
анзур	о
анилин	о
аниқ	с
аниқламоқ	ф
аниқланмиш	о
аниқлашмоқ	ф
аниқлик	о
аниқловчи	ф,о
аниқ-таниқ	с
анкер	о
анкета	о
аннексия	о
аннотация	о
аннуляция	о
анов	ол
анови	ол
анов-манов	с
анод	о
анойи	с
аномалия	о
аноним	о,с
анонимка	о
анонимчи	о
анонс	о
анор	о
анорганик	с
анордошлар	о
анорзор	о
анормал	с
ансамбль	о
антагонизм	о
антагонист	о
антагонистик	с
антарктида	о
антарктика	о
антенна	о
анти-	ю
антибиотик	о
антибиотиклар	о
антигенлар	о
антик	с
антиномия	о
антипатия	о
антисемитизм	о
антитаналар	о
антитеза	о
антитезис	о
антителолар	о
антифризлар	о
антифашист	с
антициклон	о
антиқа	с
антиқий	с
антология	о
антонимлар	о
антонимия	о
антракт	о
антрацит	о
антропо-	о
антрополог	о
антропологик	с
антропология	о
антропометрик	с
антропометрия	о
антропонимика	о
анув	ол
анурия	о
анча	р
анчагина	с
анчайин	р
анчаки	р
анча-мунча	сн
анчар	о
аншлаг	о
анъана	о
анъанавий	с
анқаймоқ	ф
анқимоқ	ф
анқо	о
анқов	о
анқовланмоқ	ф
анқовлик	о
анқовсирамоқ	ф
анғиз	о
анғирт	о
анғишламоқ	ф	
анҳор	ф
аорта	о
апартеид	о
апатит	о
апатия	о
апелляция	о
апельсин	о
апил-тапил	р
апир-шапир	р
апогей	о
апоплексия	о
апорт	о
апортлар	о
апостериори	с
апостроф	о
апоқ-чапоқ	р
апоқ-чапоқлашмоқ	ф
аппарат	о
аппаратура	о
аппаратчи	о
аппендикс	о
аппендицит	о
аппликация	о
апрель	о
априори	с
апробация	о
аптека	о
аптекачи	о
аптечка	о
апшу	т
апшурмоқ	ф
ар	о
араб	о
араби	с
арабизм	о
арабий	с
араблар	о
арабча	с,о
арабшунос	о
арабшунослик	о
арава	о
аравак	о
аравакаш	о,с
аравасоз	о
аравасозлик	о
араз	о
аразламоқ	о
аразлашмоқ	ф
аразчи	с
арайиш	о
аралаш	с,р
аралашиб-қуралашиб	р
аралашига	р
аралашма	о
аралашмоқ	ф
аралаш-қуралаш	с
аранг	р
ар-ар	т,о
арасот	о
арафа	о
арафасида	о
арақ	о
арақи	о
арқхўр	о
арақхўрлик	о
арбитр	о
арбитраж	о
арбоб	о
арвоҳ	о
арго	о
аргон	о
арготизмлар	о
аргумент	о
аргументация	о
ардоб	о
ардоқ	о
ардоқламоқ	ф
ардоқли	с
ареал	о
ареометр	о
арест	о
аржуманд	с
арз	о
арза	о
арзанда	о,с
арзандаи-кироманда	с
арзачи	о
арзгўй	о
арз-дод	о
арзигудек	с,ф
арзикулик	с,ф
арзигундай	с,ф
арзийдиган	ф
арзимаган	ф
арзимас	ф
арзимоқ	ф
арзирли	с
арзнома	о
арзон	с
арзон-гаров	р
арзон-гарон	р
арзонламоқ	ф
арзонлашмоқ	ф
арзонсинмоқ	ф
арзончилик	о
арзонқўл	с
арз-ҳол	о
ари	о
ариза	о
аризабоз	о
аризабозлик	о
аризанавис	о
аризачи	о
арилламоқ	ф
аримоқ	ф
аристократ	о
аристократизм	о
аристократик	с
аристократия	о
аристон	о
аритмия	о
арифметик	с
арифметика	о
арифмометр	о
арихона	о
аричи	о
аричилик	о
ариш	ф,о
ария	о
ариқ	о
ариқча	о
арк	о
арка	о
аркон	о
аркони	о
арконий	о
арктика	о
арман	о
армани	о
арманлар	о
арманилар	о
арматура	о
арматурачи	о
армия	о
армон	о
армуғон	о
арна	о
аро	ю,к
ароба	о
аросат	о
ароқ	о
ароқхўр	о
арпа	о
арпабодиён	о
арпапоя	о
арпағон	о
арра	о
арракаш	о
арракашлик	о
арраламоқ	о
аррачи	о
арсенал	о
арслон	о
артезиан	о
артель	о
артериосклероз	о
артерия	о
артизан	о
артикль	о
артикул	о
артикуляия	о
артиллерия	о
артиллериячи	о
артинмоқ	ф
артист	о
артистка	о
артистлик	о
артмоқ	ф
артрит	о
артрология	о
аруз	о
арфа	о
арфачи	о
архаизм	о
архаик	с
архар	о
археолог	о
археологик	с
археология	о
архив	о
архивариус	о
архивчи	о
архившунос	о
архившунослик	о
архиепископ	о
архиерей	о
архимандрит	о
архипелаг	о
архитектоник	с
архитектоника	о
архитектор	о
архитекторлик	о
архитектура	о
арча	о
арчазор	о
арчмоқ	ф
арчимоқ	ф
арш	о
аршин	о
арьергард	о
арқирамоқ	ф
арқон	о
арқонламоқ	ф
арқоқ	о
арғамчи	о
арғимчоқ	о
арғувон	о
арғувоний	с
арғумоқ	о
асаб	о
асаббозлик	ф
асабий	с
асабийланмоқ	ф
асабийлашмоқ	ф
асабийлик	о
асабият	о
асад	о
асака	о
асал	о
асалари	о
асаларичи	о
асаларичилик	о
асар	о
асбест	о
асбоб	о
асбоб-анжом	о
асбобсозлик	о
асбоб-ускуна	о
асептика	о
асил	с
асилзода	о
асимметрик	с
асимметрия	о
асир	о
асира	о
асирлик	о
аскар	о
аскарбоши	о
аскарий	о
аскарлик	о
аскарча	р
аскет	о
аскетизм	о
аския	о
аскиябоз	о
аскиябозлик	о
аскиячи	о
асл	о,с
аслан	м
аслаҳа	о
аслаҳа-анжом	о
аслаҳахона	о
асли	м
аслида	м
аслий	c
асло	ю
асно	
асо
асов
асорат
асос
асосан
асосда
асосида
асосий
асосламоқ
асосланмоқ
асосли
асоссиз
асосчи
асотир
асотирий
асп
аспаласофий
аспект
аспижаллоб
аспирант
аспирантка
аспирантура
аср
асрамоқ
асранди
асрдош
асрий
асрор
асрчилик
ассалом
ассамблея
ассимиляция
ассистент
ассистентлик
ассортимент
ассоциация
аста
аста-аста
астар
астар-арва
астарлик
астар-пахта
аста-секин
астағфирулло
астероидлар
асти
астма
астойдил
астро-
астробиология
астроботаника
астролог
астрология
астролябия
астронавт
астронавтика
астроном
астрономик
астрономия
астрофизика
асфаласофилин
асфальт
асфальтламоқ
асфальтли
асфиксия
асъаса-дабдаба
асқатмоқ
асҳоб
атавизм
атавистик
атай
атайдан
атайин
атайлаб
атака
атак-чечак
атала
аталамоқ
аталанмоқ
атала-умоч
аталмоқ
атама
атамашунос
атамашунослик
атаман
атамоқ
атан
атанмоқ
атвор
атеизм
атеист
атеистик
ателье
атеросклероз
атиги
атир
атиргул
атирсовун
атиқа
атлас
атлет
атлетик
атлетика
атлетикачи
атмосфера
атмосферавий
ато
атом
атомбоз
атомистик
атомистика
атомчи
аторид
атоқ
атоқламоқ
атоқли
атрибут
атрибутив
атроф
атрофига
атрофида
атрофия
атрофлаб
атрофли
атрофлича
аттанг
аттанга
атташе
аттестат
аттестацион
аттестация
аттор
атторлик
аттракцион
аудит
аудитор
аудитория
аукцион
аут
аутсайдер
афанди
афв
афгор
афзал
афзун
афиф
афифа
афиша
афкор
афлотун
афоризмлар
афористик
афсона
афсонавий
афсонавор
афсун
афсунгар
афсунгарлик
афсункор
афсунламоқ
афсунчи
афсус
афсуски
афсусланмоқ
афт
афт-ангор
афт-башара
афт-бош
афтидан
афтода
афтодаҳол
аффект
аффикс
афюн
афғон
афғоний
афғонлар
ахбор
ахборот
ахборотнома
ахири
ахийри
ахир
ахири
ахлат
ахлатхона
ахлоқ
ахлоқий
ахлоқли
ахлоқсиз
ахлоқсизлик
ахта
ахталамоқ
ахтармоқ
ахтахона
ацетилен
ацетон
ача
ачамбити
ачимоқ
ачимсиқ
ачимтир
ачинарли
ачиниш
ачинмоқ
ачитма
ачитмоқ
ачитқи
ачишмоқ
ачом
ачомламоқ
аччиқ
аччиқланмоқ
аччиқлашмоқ
аччиқмия
аччиқ-тииззиқ
аччиқ-тирсиқ
аччиқтош
аччиқ-чучук
ашадди
ашаддий
ашё
ашёвий
ашир
ашк
ашраф
аштак
аштак-паштак
аштархонийлар
ашула
ашулачи
ашша
ашъор
ашқол-дашқол
аъён
аъзам
аъзо
аъзолик
аълам
аъло
аълочи
аъмо
аъмол
аъроф
аэро
аэро-
аэробика
аэровокзал
аэродинамик
аэродинамика
аэродром
аэроклуб
аэромеханика
аэронавигация
аэроплан
аэропорт
аэростат
аэростатика
аэросъёмка
аэротерапия
аэрофлот
аэрофотосъёмка
аэрочана
аюҳаннос
ая
аямажиз
аямоқ
аянч
аянчли
ақалли
ақида
ақидавий
ақидапараст
ақидапарастлик
ақирмоқ
ақиқ
ақиқа
ақл
ақлан
ақлий
ақллашмоқ
ақлли
ақллилик
ақлсиз
ақл-ҳуш
ақоид
ақраб
ақрабо
ақча
ағанамоқ
ағдарма
ағдармоқ
ағдар-тўнтар
ағёр
ағнамоқ
ағраймоқ
аҳа
аҳамият
аҳамиятли
аҳамиятсиз
аҳбоб
аҳвол
аҳволот
аҳд
аҳдлашмоқ
аҳднома
аҳд-паймон
аҳён
аҳил
аҳиллашмоқ
аҳиллик
аҳилчилик
аҳком
аҳл
аҳмоқ
аҳмоқгарчилик
аҳмоқлик
аҳмоқона
аҳмоқчилик
аҳоли
