-ла	к,б
лаб	о
лаббай	у,ю
лаббайгўй	с
лаб-балаб	р
лабгардон	о
лаб-даҳан	о
лаб-даҳанли	с
лабдир	с
лабдирлик	о
лабз	о
лабир	о
лабиринт	о
лаб-лунж	о
лаболаб	р
лаборант	о
лаборантлик	о
лаборатория	о
лава	о
лаванг	с
лаванд	с
лаввоҳ	о
лавлаги	о
лавлагикор	о
лавлагикорлик	о
лавозим	о
лавозимсиз	с
лавр	с,о
лавсан	о
лавҳ	о
лавҳа	о
лаган	о
лаганбардор	о
лаганбардорларча	р
лаганбардорлик	о
лагерь	о
лаёқат	о
лаёқатли	с
лаёқатсиз	с
лазарет	о
лазги	о
лазгин	о
лазгинлар	о
лазгинча	с,о
лазер	о
лаззат	о
лаззатланмоқ	ф
лаззатли	с
лаззатсиз	с
лазиз	с
лаин	с
лайлак	о
лайлатулқадр	о
лайнер	о
лайча	о
лак	ол
лаколов	с
лак-лак	ол
лаклук	о
лакмус	о
лакот	ф
лактация	о
лаллайган	ф
лаллаймоқ	ф
лалми	с
лалмикор	с
лалмикорлик	о
лама	о
ламаизм	о
ламбада	о
ламинация	о
лампа	о
лампамой	о
лампочка	о
ланг	с,р
лангар	о
ландавур	с
ландаҳур	с
ландиш	о
ландшафт	о
ланж	с
ланжлик	о
ланка	о
лантан	о
ланцет	о
ланғилламоқ	ф
лапангламоқ	ф
лапанг-лапанг	т
лапар	о
лапарчи	о
лапашанг	с
лапашанглик	о
лаппак	с
лаппос	с
ларёк	о
ларза	о
ларзон	с
лари	о
ларингит	о
ларинголог	о
ларингология	о
ларингоскопия	о
лас	о
лат	о
латин	с
латиф	с,о
латифа	о
латифбоз	о
латифабозлик	о
латифагўй	о
латифагўйлик	о
латифачи	о
латиш	о
латишлар	о
латишча	с,о
латофат	о
латофатли	с
латта	о
латта-лутта	о
латта-путта	о
латтафуруш	о
латтачайнар	с
латунь	о
латча	о
лауреат	о
лафет	о
лафз	о
лафзан	р
лафзсиз	с
лафзсизлик	о
лахта	с
лахтак	о
лахча	с
лачак	о
лачаклик	о,с
лашкар	о
лашкарбоши	о
лашкаргоҳ	о
лаш-луш	о
лаъл	о
лаъли	о
лаънат	о
лаънати	о
лаънатламоқ	ф
лақ	о
лақаб	о
лақабланмоқ	ф
лақай	о
лақилламоқ	ф
лақ-луқ	о
лақма	с
лақмалик	о
лаққа	р,с
лаққи	с
лағмон	о
лағмонхона	о
лаҳад	о
лаҳжа	о
лаҳза	о
лаҳзалик	с
лаҳим	о
лаҳм	с
лев	о
левират	о
левомицетин	о
легал	с
легаллаштириш	ф
легаллик	о
легион	о
легионер	о
легирламоқ	ф
легитим	с
легитимация	ф,о
ледерин	о
лей	о
лейборист	о
лейка	о
лейкемия	о
лейкоз	о
лейкопения	о
лейкопластир	о
лейкоцитлар	о
лейкоцитоз	о
лейтенант	о
лейтмотив	о
лек	б,о
лекин	б,о
лексема	о
лексик	с
лексика	о
лексикограф	о
лексикографик	с
лексикография	о
лексиколог	о
лексикологик	с
лексикология	о
лексикон	о
лектор	о
лекторий	о
лекция	о
лемма	о
лемур	о
ленинизм	о
лента	о
лепра	о
лепрозорий	о
летаргия	о
летучка	о
лианалар	о
либерал	о,с
либерализм	о
либераллаштириш	ф
либерализация	ф
либос	о
либретто	о
либретточи	о
ливит	о
ливитчи	о
лига	о
лидер	о
лизинг	о
лик	т
ликангламоқ	ф
ликанг-ликанг	т
ликвид	о
ликёр	о
ликилдоқ	с
ликилламоқ	ф
лик-лик	т
ликоп	о
ликопча	о
лилипут	о
лим	с,р
лиман	о
лимилламоқ	ф
лимит	о
лимитламоқ	ф
лиммо-лим	с
лимон	о
лимонад	о
лимонарий	о
лимонзор	о
лимонли	с
лиму	о
лимузин	о
лимфа	о
лимфаденит	о
лимфатик	с
лингафон	о
лингвист	о
лингвистик	с
лингвистика	о
линейка	о
линза	о
линимент	о
линия	о
линкор	о
линолеум	о
линотип	о
линотипчи	о
линт	о
линтер	о
линтерчи	о
линча	о
лип	т
липа	о
липилламоқ	ф
лип-лип	р
липпа	р
лира	о
лиризм	о
лирик	о,с
лирика	о
лисон	о
лисоний	с
лист	о
листаж	о
лит	о
литер	о
литера	о
литий	о
литограф	о
литографик	с
литография	о
литология	о
литосфера	о
литота	о
литр	о
литраж	о
литрли	с
лифт	о
лифтёр	о
лифтчи	о
лифчик	о
лицей	о
лицензия	о
личинка	о
лишайник	о
лиқ	т
лиқилдоқ	с
лиқилламоқ	ф
лиқлиқ	о
лиққо	с
лиққоқ	с
лоақал	ю
лобар	с,о
лобзик	о
лобид	с
лов	т
лова	о
ловадан	о
ловия	о
ловулламоқ	ф
логарифм	о
логарифмик	с
логик	о,с
логистика	о
логограмма	о
логопатия	о
логопедия	о
лодон	с
ложа	о
ложувард	о,с
лозим	м
лозиманда	о
лозимлик	о
лозимомада	о
лой	о
лойгарлик	о
лойгарчилик	о
лойиқ	с
лойиғича	р
лойиҳа	о
лойиҳаламоқ	ф
лойиҳалаш	о
лойиҳаловчи	о
лойиҳачи	о
лойкаш	о
лойламоқ	ф
лойли	с
лойхона	о
лойхўрак	о
лойчақир	о
лойқа	с
лойқаланмоқ	ф
лойқалатмоқ	ф
лойқамоқ	ф
лойқтмоқ	ф
лок	о
локал	с
локализация	о
локатор	о
локация	о
локаут	о
локин	б
локламоқ	ф
локомотив	о
лол	с
лола	о
лолагул	о
лолагун	с
лолазор	о
лоларанг	с
лолақизғалдоқ	о
лом	о
ломакон	с
ломбард	о
лом-мим	о
лоп	т
лопилламоқ	ф
лоп-лойиқ	с
лоппа-лойиқ	с
лорд	о
лодсилдоқ	с
лорсилламоқ	ф
лорс-лорс	т
лос	о
лосось	о
лосьон	о
лот	о
лотерея	о
лотин	с
лотинлаштирмоқ	ф	
лотинча	с
лот-манот	о
лото	о
лоток	о
лоток	о
лотокчи	о
лоуренсий	о
лоф	о
лофчи	о
лоф-қоф	о
лоцман	о
лочин	о
лочира	о
лош	о
лоямут	с
лоқайд	р,с
лоқайдлик	о
лоғар	с
лоҳас	с
лоҳасланмоқ	ф
луб	о
лубкор	о
луза	о
лузум	о
лузумсиз	с
лунги	о
лунж	о
луноход	о
лупа	о
лутф	о
лутфан	р
лутфкорлик	о
лутфкорона	р
лух	о
луччак	с
луқма	о
луқмон	о
луғавий	с
луғат	о
луғатчи	о
луғатчилик	о
луғатшунос	о
люизит	о
люк	о
люкс	о
люксметр	о
люмбаго	о
люмен	о
люменисценция	о
люмпен-пролетариат	о
люстра	о
лютеций	о
ля	о
ляпис	о
лўк	о
лўкидон	о
лўкилламоқ	ф
лўкки	о
лўк-лўк	т
лўкча	о
лўла	о
лўли	о
лўливаш	с
лўлилар	о
лўлилик	о
лўмбиллаб	р
лўмбиллаган	с
лўмбоз	о
лўмбоздай	с
лўнда	с
лўп	т
лўппак	с
лўппи	с
лўпчик	о
лўттибоз	о
лўтиибозлик	о
лўя	о
лўқ	т
лўқилламоқ	ф
лўқ-лўқ	р
