у	ол
уборшица	о
у-бу	ол
ув	т
ува	о
увада	о,с
увадаланмоқ	ф
увадачи	о
уваламоқ	ф
уваланувчан	с
ували-жували	с
увалло	р
увалмоқ	ф
уват	о
уввало	р
уввос	о
увертюра	о
увиз	о
увишмоқ	ф
увламоқ	ф
увол	о
увоқ	о,с
увоқламоқ	ф
увулдириқ	о
увулламоқ	ф
увун-тўда	о,с
увушмоқ	ф
углеводлар	о
углеводородлар	о
углерод	о
угра	о
уд	о
удайчи	о
ударник	о
удда	о
уддабуро	с
уддабурон	с
уддабуролик	о
уддабуронлик	о
уддаламоқ	ф
удли-шудли	с
удмурт	о
удмуртлар	о
удум	о
уезд	о
уза	к
узаймоқ	ф
узала	о
узаласига	р
узалмоқ	ф
узамоқ	ф
узана	р
узанги	о
узангисоз	о
узанмоқ	ф
узатмоқ	ф
узв	о
узвий	с
узгич	о
узел	о
уззол	о
уззукун	р
узикмоқ	ф
узил-кесил	р
узилмоқ	ф
узлат	о
узлатнишин	о
узлукмоқ	ф
узлуксиз	р
узма	о
узмоқ	ф
узор	о
узоқ	р,о
узоқламоқ	ф
узоқлашмоқ	ф
узоқлик	о
узоқмоқ	ф
узр	о
узра	к
узрли	с
узр-маъруз	о
узрсиз	с
узуал	с
узук	о
узукли	с
узум	о
узумзор	о
узумчи	о
узумчилик	о
узун	с
узунасига	р
узунлашмоқ	ф
узунлик	о
узунчоқ	с
узунқанот	о
узунқулоқ	с
узурпатор	о
узурпация	о
узуқ	с
узуқ-юлуқ	с
уй	о
уйдирма	о
уйдирмачи	о
уйдирмоқ	ф
уй-жой	о
уй-жойли	с
уйимоқ	ф
уйкўрар	о
уйламоқ	ф
уйланмоқ	ф
уйлантирмоқ	ф
уйли	с
уймаланмоқ	ф
уймалашмоқ	ф
уймоқ	ф
уй-рўзғор	о
уйсиз	с
уйсоз	о
уйсозлик	о
уйқаш	к,р,с
уйқи-туйқи	р
уйқу	о
уйқули	с
уйқусиз	с,р
уйқусизлик	о
уйқусирамоқ	ф
уйқутоб	р
уйқучи	о
уйқучил	о
уйғониш	ф
уйғонмоқ	ф
уйғоқ	р
уйғун	с
уйғунлашмоқ	ф
уйғунлик	о
уйғур	о
уйғурлар	о
уйғурча	р,с
ука	о
укалик	о
уккилар	о
уклад	о
укол	о
укпа	о
укпар	о
украин	о,с
украинлар	о
украинча	с,р
укроп	о
уксус	о
ул	о,ол
улагич	о
улай-булай	ол
улама	с
уламо	о
уламоқ	ф
улашмоқ	ф
улаш-улаш	о
ул-бул	ол
улги	о
улгу	о
улгуржи	с,р
улгуриш	ф
улгурмоқ	ф
ули	т
улимоқ	ф
улкан	с
улканлашмоқ	ф
улли	с
улов	о
уловли	с
улор	о
улоқ	о,с
улоқмоқ	ф
улоқтирмоқ	ф
улоқчи	о
улоқ-қуроқ	с
ултон	о
улум	о
улус	о
улуш	о
улуғ	с
улуғвор	с
улуғворлик	о
улуғзода	о
улуғламоқ	ф
улуғлашмоқ	ф
улуғлик	о
улуғсифат	с
улуғсифатлик	о
улфат	о,с
улфати	с
улфатлашмоқ	ф
улфатчилик	о
ультиматум	о
ультрабинафша	с
ультрамикроскоп	о
ультратовуш	о
ультрақисқа	с
улғаймоқ	ф
умаро	о
умбалақашмоқ	ф
умбалоқ	о
умбурвоқи	о
умивальник	о
умид	о
умидбахш	с
умидвор	с
умидворлик	о
умидлантирмоқ	ф
умидли	с,р
умидсиз	с,р
умидсизланмоқ	ф
умидсизларча	р
умидсизлик	о
уммат	о
уммон	о
умоч	о
умр	о
умра	о
умрбод	р
умрбоқи	о
умргузаронлик	о
умрдош	о
умрдошлик	о
умрли	с
умрлик	с,р
умсунмоқ	ф
умтилмоқ	ф
умум	о
умуман	р
умумбашарий	с
умумдавлат	с
умумдемократик	с
умумий	с
умумийлик	о
умумлашма	с,о
умумлашмоқ	ф
умуммиллий	с
умумпартиявий	с
умумреспублика	с
умумхалқ	с
умуртқа	о
умуртқалар	о
умуртқалилар	о
умуртқасизлар	о
ун	о
унамоқ	ф
унар-унмас	о
унашмоқ	ф
унаштириш	ф
унаштирмоқ	ф
унақа	с
унақанги	с
унвон	о
унгур	о
унда	ол,б
унда-бунда	р
ундай	ол
ундалма	о
ундамоқ	ф
унда-мунда	р
ундан-бундан	о
ундов	о
ундовчи	ф
ундош	с
ундоқ	ол
универмаг	о
универсал	с
универсалчи	о
универсам	о
универсиада	о
университет	о
уникал	с
унитар	с
унификация	о
унификациялаштирмоқ	ф
унли	с
унмоқ	ф
уннамоқ	ф
унниқмоқ	ф
уноби	о
унс	о
унсиз	с
унсур	о
унтер-офицер	о
унум	о
унумдор	с
унумдорлик	о
унумли	с
унумсиз	с
унут	о
унутмоқ	ф
унча	ол,сн
унчалик	ол,сн
унча-мунча	сн
упа	о
упа-элик	о
упор	о
упқун	о
ура	у,ф
уран	о
урбанизация	о
урвоқ	о
урён	о,р
урилмоқ	ф
уринма	о
уринмоқ	ф
уринчоқ	с
уриш	ф
уришиғли	с
уришмоқ	ф
уриштирмоқ	ф
уришқоқ	с
ур-йиқит	о
ур-калтак	о
урмоқ	ф
урна	о
урнамоқ	ф
уролог	о
урологик	с
урология	о
урпоқ	о
ур-сур	о
уртмоқ	ф
уртук	о
уруш	о
уруғ	о
уруғдон	о
уруғдош	о
уруғламоқ	ф
уруғланмоқ	ф
уруғли	с
уруғлик	с
уруғхона	о
уруғчи	о
уруғчилик	о
уруғшунос	о
уруғшунослик	о
урф	о
урчимоқ	ф
урчуқ	о
урғочи	с
урғу	о
урғули	с
урғусиз	с
ускуна	о
ускуналамоқ	ф
услуб	о
услубий	с
услубият	о
услубшунослик	о
усмонли	с
уст	о
уста	о
устабузармон	о
устав	о
устазода	о
устакор	о
устакорлик	о,с
усталик	о
устама	о
установка	о
устара	о
устахона	о
устачилик	о
уст-бош	о
устига-устак	м
устки	с
устма-уст	р
устод	о
устодона	р
устоз	о
устозлик	о
устомон	с
устомонлик	о
устувор	с,р
устун	о,с
устунлик	с,о
устунча	о
уст-устига	р
устухон	о
устқурма	о
усул	о
усулчи	о
утиль	о
утмоқ	ф
утопизм	о
утопик	с
утопист	о
утопия	о
уторид	о
уф	у
уфламоқ	ф
уфолог	о
уфология	о
уфор	о
уфурмоқ	ф
уфқ	о
ухламоқ	ф
ухлоқ	р
уху	т
уч	о
уча	о
учак	о
учалатой	о
учар	ф
участка	о
участковой	о
учбурчак	с,о
учёт	о
учётчи	о
учириқ	о
учирма	о
учламоқ	ф
учламчи	с,м
учли	с
учлик	о
учма-уч	р
учмох	о
учмоқ	ф
учовора	р,с
учоқ	о
учрамоқ	ф
учрашмоқ	ф
учрашув	ф
учувчи	о
учувчилик	о
учун	к
учуниқ	о
учунмоқ	ф
учуриқ	о
учуқ	о,с
учқун	о
учқунламоқ	ф
учқур	с
ушалмоқ	ф
ушатмоқ	ф
ушбу	ол
ушламоқ	ф
ушоқ	о
ушр	о
ушу	о
у-шу	о
ушук	о
ушшоқ	о
уюм	о
уюмоқ	ф
уюр	о
уюрма	о
уюшиқ	с
уюшма	о
уюшмоқ	о
уюштирмоқ	ф
уюшқоқ	с
уюшқоқлик	о
уя	о
уяламоқ	ф
уяли	с
уялмай-нетмай	р
уялмоқ	ф
уят	о
уятли	с
уятмоқ	ф
уятсиз	с
уятсизлик	о
уятчан	с
уятчанлик	о
уқа	о
уқаламоқ	ф
уқмоқ	ф
уқтириш	ф
уқубат	о
уқубатли	с
уқув	о
уқувли	с
уқувсиз	с
уғон	о
уҳ	у
уҳда	о
уҳламоқ	ф
