фа	о
фабрика	о
фабрикант	о
фабрикат	о
фабрикачи	о
фабула	о
фаввора	о
фавт	о
фавқулодда	с,р
фагоцит	о
фаже	с
фаза	о
фазилат	о
фазилатли	с
фазиҳат	о
фазл	о
фазл-камолот	о
фазо	о
фазовий	с
фзогир	о
фазогирлик	о
фазокор	о
фазометр	о
фазотрон	о
файз	о
файзбахш	с
файзиёб	с
файзли	с
файзсиз	с
файз-тароват	о
файз-футур	о
файз-ҳаловат	о
файл	о
файласуф	о
файласуфлик	о
файласуфнамо	с,р
файтон	о
файтончи	о
факс	о
факсимил	с
факсимиле	о
факт	о
фактик	с
фактор	о
фактура	о
факультатив	с
факультет	о
факультетлаларо	с
фалаж	о
фалажламоқ	ф
фалак	о
фалакат	о
фалакиёт	о
фалақ	о
фаллоҳ	о
фалокат	о
флокатзада	о
фалокатли	с
фалокатсиз	р,с
фалон	ол
фалонча	сн
фалончи	ол
фалсафа	о
фалсафий	с
фалсафийлик	о
фальсификатор	о
фальсификация	о
фамил	о
фамилия	о
фамилиядош	о
фан	о
фанатизм	о
фанатик	о,с
фанер	о
фанера	о
фанний	с
фано	о
фанор	о
фанта	о
фантазия	о
фантаст	о
фантастик	с
фантастика	о
фанфара	о
фаншунослик	о
фаол	с,о
фаола	о
фаолият	о
фаолиятсиз	с
фаолиятсизлик	о
фаоллик	о
фар	о
фара	о
фараз	о
фаразан	р
фаразий	с
фаразия	о
фаранг	о
фаранги	с
фарангий	с
фарангистон	о
фараҳ	о
фараҳбахш	с
фараҳли	с
фараҳлик	о
фараҳманд	с
фараҳнок	с
фард	с
фарёд	о
фарз	о
фарзанд	о
фарзандли	с
фарзандлик	с
фарзандсиз	с
фарзандсизлик	о
фарзандталаб	о
фарзин	о
фарзона	с
фарингит	о
фаришта	о
фариштали	с
фариштасиз	с
фармакогнозия	о
фармаколог	о
фармакологик	с
фармакология	о
фармакотерапия	о
фармацевт	о
фармацевтика	о
фармация	о
фармойиш	о
фармон	о
фармоначи	о
фармонбардор	с
фармоннома	о
фармономуз	с
фармуда	о
фаровон	с
фаровонлик	о
фароиз	о
фаройиз	о
фаромуш	р
фаромушлик	о
фаромушхотир	с
фаросат	о
фаросатли	с
фаросатсиз	с
фароғ	о
фароғат	о
фароғатли	с
фароғатсиз	с
фаррош	о
фаррошлик	о
фарсанг	сн
фарсах	сн
фартук	о
фарфор	о
фарш	о
фарқ	о
фарқламоқ	ф
фарқланмоқ	ф
фарқли	с
фарқловчи	о
фарқсиз	с
фарғонача	о
фас	о
фасад	о
фасиҳ	р,с
фасл	о
фасод	о
фасодламоқ	ф
фасодчи	о
фасон	о
фасона	о
фасоҳат	о
фасоҳатли	с
фатал	с
фатализм	о
фаталист	о
фаталистик	с
фатво	о
фатвохон	о
фатила	с
фаттон	с
фатҳ	о
фатҳа	о
фатҳ-нусрат	о
фауна	о
фахр	о
фахрий	с
фахрия	о
фахрланмоқ	ф
фахрли	с
фаш	о
фашизм	о
фашист	о
фаэтон	о
фақат	р
фақир	с
фақирлашмоқ	ф
фақирлик	о
фақирона	р
фақир-фуқаро	о
фақиҳ	о
фаҳм	о
фаҳмламоқ	ф
фаҳмли	с
фаҳмсиз	с
фаҳм-фаросат	о
фаҳш	о
фаҳшият	о
фаҳшхона	о
февраль	о
федерал	с
федерализм	о
федералист	о
федератив	с
федерация	о
фельдмаршал	о
фельдшер	о
фельдъегерь	о
фельетон	о
фельетончи	о
фен	о
фенол	о
фенолог	о
фенология	о
феномен	о
феноменализм	о
феодал	о,с
феодализм	о
феодалларча	р
ферма	о
фермент	о
ферментлар	о
ферментатив	с
ферментация	о
фермер	о
фермий	о
ферромагнит	о,с
ферроқотишмалар	о
феррум	о
феруз	о
феруза	с
фестиваль	о
фетиш	о
фетишизм	о
феъл	о
феълан	р
феъл-атвор	о
феълдор	с
феъллик	о
феъл-хўй	о
фён	о
фибра	о
фиброма	о
фигор	о
фигура	о
фигурали	с
фигурачи	о
фидеизм	о
фидо	о
фидойи	с,о
фидойилик	о
фидокор	с,о
фидокорлик	о
фидокорона	р
физик	о,с
физика	о
физикавий	с
физиолог	о
физиологик	с
физиология	о
физиотерапевт	о
физиотерапевтик	с
физиотерапия	о
физкультура	о
физкультурачи	о
фикр	о
фикран	р
фикрат	о
фикрдош	о
фикр-ёд	о
фикр-зикр	о
фикрий	с
фикрламоқ	ф
фикрлашмоқ	ф
фикрлашув	ф
фикрли	с
фикр-мулоҳаза	о
фикр-хаёл	о
фикр-ўй	о
фиксаж	о
фил	о
филантроп	о
филантропия	о
филармония	о
филателист	о
филателия	о
филбон	о
филжумла	м
филиал	о
филмой	о
филогенез	о
филолог	о
филологик	с
филология	о
философ	о
философик	с
философия	о
фильм	о
фильм-концерт	о
фильмоскоп	о
фильмотека	о
фильтр	о
фильтрация	о
фильтрламоқ	ф
фильтрли	с
филғон	о
филҳақиат	р
филҳол	р
фимоз	о
фин	о
финал	о
финалист	о
финалчи	о
финжон	о
финиш	о
финка	о
финлар	о
финча	с
фирдавс	о
фирдавсмонанд	с
фириб	о
фирибгар	о
фирибгарлик	о
фирма	о,с
фироқ	о
фируз	о
фируза	о
фиръавн	о
фирқа	о
фирқавий	с
фирқали	с
фирқасиз	с
фисқ	о
фисқ-фасод	о
фисқ-фасодчи	о
фисқ-фужур	о
фитна	о
фитнагар	о
фитнакор	о
фитнакорлик	о
фитналик	о
фитна-фасод	о
фитна-фасодчи	о
фитначи	о
фитобар	о
фитонцид	о
фитопатология	о
фитотерапия	о
фитофаглар	о
фитр	о
фиқҳ	о
фиқҳий	с
фиғон	о
фиғонли	с
флагман	о
флагшток	о
флакон	о
фламинго	о
фланг	о
флейта	о
флейтачи	о
флексия	о
флектив	с
фломастер	о
флора	о
флот	о
флотилия	о
флюгер	о
флюорография	о
фляга	о
фоже	о
фожеий	с
фожиа	о
фожиавий	с
фожиали	с
фожиона	р
фожир	о
фожи	с
фожиъ	с
фозил	о
фозила	о
фоиз	о
фойда	о
фойдаланмоқ	ф
фойдали	с
фойдасиз	с,р
фойдаталаб	с
фойдахўр	о
фойе	о
фойтун	о
фойтунчи	о
фокстрот	о
фокус	о
фокусчи	о
фол	о
фолбин	о
фолбинлик	о
фольга	о
фольклор	о
фольклорист	о
фольклористика	о
фольклорчи	о
фольклоршунос	о
фольклоршунослик	о
фон	о
фонарь	о
фонд	о
фонема	о
фонематик	с
фонендоскоп	о
фонетик	с
фонетика	о
фонетист	о
фоний	с
фонограмма	о
фонограф	о
фонографик	с
фонологик	с
фонология	о
фонометр	о
фонотека	о
фонтан	о
фонус	о
форинт	о
фориғ	с
фориғбол	р
форма	о
формал	с
формализм	о
формалин	о
формалинлмоқ	ф
формалист	о
формалистик	с
формат	о
форматли	с
формация	о
формовка	о
формула	о
формулировка	о
формуляр	о
форпост	о
форс	о
форсигўй	с
форсий	о,с
форсихон	о
форслар	о
форсунка	о
форсча	р,о
фортепьяно	о
форточка	о
форум	о
фосген	о
фосид	с
фосиқ	с
фосфатламоқ	ф
фосфатлар	о
фосфатли	с
фосфор	о
фосфоритлар	о
фосфорли	с
фотиҳ	о
фотиҳа	о
фотиҳали	с
фотиҳахон	о
фотиҳахонлик	о
фотиҳачи	о
фотиҳлик	о
фотмачумчуқ	о
фото	о
фотоаппарат	о
фотобиология	о
фотограф	о
фотографик	с
фотография	о
фотографлик	о
фотокамера	о
фотокимё	о
фотокопия	о
фотокўргазма	о
фотолаборатория	о
фотолампа	о
фотолента	о
фотолиз	о
фотолитография	о
фотоматериал	о
фотометр	о
фотометрик	с
фотометрия	о
фотомонтаж	о
фотомухбир	о
фотон	о
фтонусха	о
фотопластинка	о
фоторасм	о
фоторепортаж	о
фоторепортёр	о
фотосинтез	о
фотосурат	о
фотосъёмка	о
фототелеграмма	о
фототелеграф	о
фототерапия	о
фотохроника	о
фоточи	о
фотоэлемент	о
фотоқоғоз	о
фотоҳаваскор	о
фотоҳужжат	о
фохира	о
фохта	о
фош	ф
фоҳиш	с
фоҳиша	о
фоҳишабоз	о
фоҳишабозлик	о
фоҳишалик	о
фоҳишахона	о
фрагмент	о
фраза	о
фразема	о
фразеологизм	о
фраеологик	с
фразеология	о
фрак	о
фракцион	с
фракциоонер	о
фракция	о
франк	о
франция	о
француз	о
французлар	о
французча	с,о
фреза	о
фрезаламоқ	ф
фрезеровкачи	о
фрезерчи	о
фреска	о
фрикатив	с
фриц	о
фронт	о
фронтдош	с
фронтовик	о
фронтча	р
фронтчасига	р
фронтчи	о
фруктоза	о
фтузиатр	о
фтизиатрия	о
фтор	о
фторли	с
фу	у
фугас	о
фужер	о
фузало	о
фузул	о
фузун	с
фундамент	о
фундаментал	с
фундаментализм	о
финдаменталист	о
функционал	с
функция	о
фунт	о
фунун	о
фуражка	о
фургон	о
фурсат	о
фуруш	ф
фурушанда	о
фурфурол	о
фурқат	о
фусаҳо	о
фусун	о
фусунгар	о
фусункор	с
фусункорлик	о
футбол	о
футболка	о
футболчи	о
футувват	о
футур	о
футуризм	о
футурист	о
футуристик	с
футурология	о
фуфайка	о
фуқаро	о
фуқаролик	о
фуқаропарвар	с
фуқаропарварлик	о
фюзеляж	о
фюрер	о
фўта	о
