хабар	о
хабардор	о,с
хабаркаш	о
хабаркашлик	о
хабарламоқ	ф
хабарнома	о
хабарсиз	с
хабарсизлик	о
хабарчи	о
хабис	с
хавотир	о
хавотирланмоқ	ф
хавотирли	с
хавотирлик	о
хавотирона	р
хавотирсиз	с
хавф	о
хавфланмоқ	ф
хавфли	с
хавфнок	с
хавфсиз	с
хавфсизлик	о
хавфсинмоқ	ф
хавфсирамоқ	ф
хавфсиранмоқ	ф
хавф-хатар	о
хаёл	о
хаёлан	р
хаёлий	с
хаёлкаш	о
хаёлланмоқ	ф
хаёлот	о
хаёлпараст	о
хаёлпарастлик	о
хаёлпаришон	о
хаёлпаришонлик	о
хаёлсирамоқ	ф
хаёлхона	о
хаёлчан	р
хаёлчанлик	о
хазанак	о
хазарлар	о
хазина	о
хазинабон	о
хазинадор	о
хазинахона	о
хазиначи	о
хазиначилик	о
хазон	о
хазонмарг	о
хазонрез	о
хазонрезги	о
хазонрезгилик	о
хазонрезлик	о
хазончинак	о
хай	м
хайитқора	о
хайл	о
хайр	о,м,у
хайрихоҳ	о
хайрихоҳлик	о
хайрихоҳона	р
хайрия	о
хайрият	м
хайриятки	м
хайриятлик	о
хайрлашмоқ	ф
хайрлашув	ф
хайрли	с
хайр-маъруз	о
хайр-садақа	о
хайр-хўш	о
хайр-хўшламоқ	ф
хайрчи	о
хайр-эҳсон	о
хакас	о
хакаслар	о
хакер	о
хаки	с,о
хала	о
халакаш	с
халал	о
халат	о
халатли	с
халаф	о
халачўп	о
халақит	о
халили	о
халилий	о
халилуллоҳ	о
халифа	о
халифалик	о
халлоқ	о
халлоқи	с
хало	о
халожой	о
халойиқ	о
халос	о
халоскор	о
халоскорлик	о
халохона	о
халта	о
халта-хулта	о
халтача	о
халтура	о
халтурачи	о
халтурачилик	о
халфа	о
халқ	о
халқаро	с
халқоб	с
халқона	с
халқпарвар	о
халқпарварлик	о
халқчил	с
халқчилик	о
халқчиллик	о
хам	с
хамак	о
хамелеон	о
хамир	о
хамиргир	о
хамирсимон	с
хамиртуруш	о
хампа	о
хамса	о
хамсанавис	о
хамсачилик	о
ханда	о
хандақ	о
хандон	с
хандон-хушон	р
ханжар	о
ханжарбозлик	о
ханжувар	о
ханик	о
хантал	о
ханталли	с
хар	о
харажат	о
харак	о
харакири	о
характер	о
характеристика	о
характерламоқ	ф
характерланмоқ	ф
характерли	с
харгўш	о
харж	о
харжламоқ	ф
хари		о
харибоп	с
харид	о
харидор	о
харидорбоп	с
харидоргир	с
харилик	с
харита	о
харитаграфия	ф
хариташунослик	о
хариш	о
харишланмоқ	ф
хароб	с
хароба	о,с
харобагарчилик	о
харобазор	о
харобалик	о
хароблашмоқ	ф
хароблик	о
харобот	о
харрак	о
харрот	о
харсанг	о
харсангтош	о
хартия	о
хартум	о
хартумча	о
хархаша	о
хархашали	с
хархашасиз	р,с
хархашачи	о
хас	о
хасва	о
хасис	о
хасислашмоқ	ф
хасислик	о
хаскаш	о
хасм	о
хасмол	о
хаспўш	о
хаспўшламоқ	ф
хаста	с
хастадил	с
хастадиллик	о
хасталанмоқ	ф
хасталик	о
хастахона	о
хастаҳол	с
хас-хашак	о
хас-чўп	о
хат	о
хата	о
хатар	о
хатарли	с
хатарнок	с
хатарсиз	с
хатбоши	о
хатиб	о
хаткаш	о
хатламоқ	ф
хатлашмоқ	ф
хатли	с
хатм	о
хат-маҳр	о
хатти-маҳр	о
хатна	о
хато	о
хатолик	о
хатосиз	р,с
хатпараст	с
хат-пат	о
хат-савод	о
хат-саводли	с
хат-саводсиз	с
хат-муҳр	о
хатти-райҳон	о
хатти-ҳаракат	о
хаттот	о
хаттотлик	о
хат-хабар	о
хатчўп	о
хат-ҳужжат	о
хафа	с
хафагазак	о
хафагахаклик	о
хафагарчилик	о
хафаланмоқ	ф
хафалашмоқ	ф
хафалик	о
хафаомуз	р
хафахон	с
хафачилик	о
хафақон	с,о
хафаҳол	с
хафиф	с
ха-ха-ха	у
хахоламоқ	ф
хахо-тарала	о
хачир	о
хашак	о
хашаки	с
хашакламоқ	ф
хашакхона	о
хашак-хушак	о
хаштак-паштак	о
хез	о
хезламоқ	ф
хезланмоқ	ф
хели-хеш	о
хемосинтез	о
хемосорбция	о
хехеламоқ	ф
хе-хе-хе	у
хеш	о
хеш-ақрабо	о
хешлик	о
хи	у
хивич	о
хивичламоқ	ф
хиёбон	о
хиёл	р
хиёнат	о
хиёнатгар	о
хиёнатгарлик	о
хиёнаткор	о
хиёнаткорлик	о
хиёнаткорона	р
хиёнатчи	о
хиёнатчилик	о
хижил	с
хижиллик	о
хижолат	о
хижолатли	с
хижолатлик	о
хижолатомуз	р
хижолатпазлик	о
хизмат	о
хизматдош	о
хизматкаш	о,с
хизматкор	о
хизматкорлик	о
хизматона	о
хизматчи	о
хизр	о
хийла	о
хийли	о
хил	о
хилват	с,о
хилватгоҳ	о
хилватнишин	о
хилватхона	о
хилламоқ	ф
хилли	с
хилма-хил	с
хилма-хиллик	о
хилондон	о
хилоф	с,р
хилт	о
хил-хил	р
хилхона	о
хилъат	о
хилқат	о
химик	о
химикат	о
химия	о
химиявий	с
хина	о
хинагул	о
хиналамоқ	ф
хинали	с
хинзир	о
хинин	о
хино	о
хиппа	р
хипча	с
хипчалашмоқ	ф
хипчин	о
хипчинламоқ	ф
хира	с
хирад	о
хирадманд	о
хираланмоқ	ф
хиралашмоқ	ф
хиралик	о
хирахандон	о
хиргойи	о
хирилдоқ	о
хирилламоқ	ф
хириллаш	ф
хириллашмоқ	ф
хириллоқ	о
хирмон	о
хирмон-хирмон	сн
хирож	о
хиром	о
хиромон	с
хирпа	с
хирпаламоқ	ф
хирпи	с
хирс	о
хирург	о
хирургик	о
хирургия	о
хир-хир	т
хирқа	о
хирқапўш	о
хирқи	о
хирқирамоқ	ф
хирқироқ	с
хислат	о
хислатли	с
хит	с
хитланмоқ	ф
хитлик	о
хитоб	о
хитобан	р
хитобнома	о
хитой	о,с
хитойи	с
хитойлар	о
хитойча	с
хитойшунос	о
хитойшунослик	о
хих	у
хи-хи	т
хихиламоқ	ф
хихламоқ	ф
хишт	о
хиштак	о
хиштин	с
хлор	о
хлорламоқ	ф
хлорли	с
хлорофилл	о
хлороформ	о
хоб	о
хобгоҳ	о
хобхона	о
хода	о
ходим	о
ходима	о
ходимгар	о
ходими	о
ходимлик	о
ходимчи	о
ходмигар	о
хожа	о
хоин	о
хоинларча	р
хоинлик	о
хоинона	р
хок	о
хока	о
хокандоз	о
хоки	о
хокипой	о
хокипок	о
хокисор	с
хоксор	с
хокисорлик	о
хоксорлик	о
хокисорона	р
хоксорона	р
хокитуроб	с
хокитўзон	с
хоккей	о
хоккейчи	о
хол	о
хола	о
холавачча	о
холдинг	о
холдор	с
холецистит	о
холи	с,р
холилатмоқ	ф
холис	с
холисанлилло	р
холисанлиллоҳ	р
холислик	о
холисона	р
холиқ	с,о
холл	о
холли	с
холодильник	о
холойи	о
холос	ю
холпаранг	с
хол-хол	с
хом	с
хома	о
хомак	о
хомаки	с
хомакламоқ	ф
хомашё	о
хомиқмоқ	ф
хомкалла	о
хомлигича	р
хомлик	о
хоммапиш	о
хомсемиз	с
хомсимоқ	ф
хомсирамоқ	ф
хомсувоқ	с
хомсурп	о
хомсўз	с
хомталаш	ф
хомтама	о
хомтамалик	о
хомтараш	о
хомток	о
хомут	о
хомуш	с,р
хомушланмоқ	ф
хомушлик	о	
хом-хатала	с
хомчўт	о
хомчўтламоқ	ф
хомқолип	с
хон	о
хона	о
хонавайрон	с
хонадон	о
хоназод	с
хонаки	с
хонакилашмоқ	ф
хонали	с
хонанда	о
хонанишин	с
хонасаллот	с
хонаси	о
хонатлас	о
хонақоҳ	о
хонақоҳнишин	с
хонзода	о
хоним	о
хониш	о
хонлик	о
хонтахта	о
хонумон	о
хонқизи	о
хор	с
хорват	о
хорватлар	о
хоргул	о
хореографик	с
хореография	о
хор-зор	р
хор-зорлик	о
хориж	о
хорижий	с
хориқулодда	с
хорламоқ	ф
хорлик	о
хорлик-зорлик	о
хормейстер	о
хор-хас	о
хос	с
хоса	с
хосаки	с
хосият	о
хосиятли	с
хосиятсиз	с
хосланмоқ	ф
хослик	о
хосс	о
хосхона	о
хотам	о
хотима	о
хотин	о
хотинак	с
хотинбоз	о
хотинёнғоқ	о
хотинли	с
хотинлик	о
хотинпараст	о
хотинсиз	с
хотинсизлик	о
хотинфуруш	о
хотин-халаж	о
хотинча	р
хотинчалиш	с
хотинчасига	р
хотин-қизлар	о
хотир	о
хотира	о
хотиржам	с,р
хотиржамланмоқ	ф
хотиржамлик	о
хотирламоқ	ф
хотирот		о
хоч	о
хоқон	о
хоқоний	с
хоқонлик	о
хоҳ	б
хоҳиш	о
хоҳлаган	ф
хоҳладим	ф
хоҳламоқ	ф
хоҳ-нохоҳ	р
хрен	о
хрестоматия	о
хризантема	о
христиан	о,с
христианлик	о
хром	о
хромлаш	о
хромосомалар	о
хромосфера	о
хроник	с
хроника	о
хроникал	с
хронобиология	о
хронологик	с
хронология	о
хронометр	о
хронометраж	о
хронометражчи	о
хронометрик	с
хрусталь	о
хувари	о
худ	c
худ-бехуд	о
худбин	с
худбинлик	о
худбинлашмоқ	ф
худди	с
худком	о
худо	о
худой	о
худобезор	о
худобезори	о
худобехабар	с
худованд	с
худовандо	о
худогўй	с
худоё	о
художў	с
художўй	с
художўйлик	о
худойи	о
худойихона	о
худойихўр	о
худойичи	о
худопараст	с
худосиз	с
худотарс	о
худпараст	с
хук	о
хулё	о
хулиган	о
хуллас	м
хулласи	м
хулласки	м
хулоса	о
хулосавий	с
хулосаламоқ	ф
хулқ	о
хулқ-атвор	о
хум	о
хумбош	с,о
хумдай	с
хумдон	о
хумдончи	о
хумкалла	с,о
хумлаб	р
хумор	о
хуморгарчилик	о
хумори	о
хуморлик	о
хумпар	о
хумса	о
хумча	о
хун	о
хунаса	о
хунбор	с,о
хундор	о
хунибийрон	с
хуноб	с
хуноба	с
хунобагарчилик	о
хунобгарчилик	о
хуноблик	о
хунолуд	с
хунрез	о,с
хунрезлик	о
хунук	с
хунуклашмоқ	ф
хунуклик	о
хунхор	о
хунхўр	о
хунхўрлик	о
хурал	о
хуржун	о
хуржунлашмоқ	ф
хурилламоқ	ф
хурма	о
хурмача	о
хурмақовоқ	о
хурмо	о
хурмозор	о
хурмойи	с
хурофий	с
хурофот	о
хурофотфуруш	о
хурофотчи	о
хуррак	о
хурракчи	о
хуррам	р,о
хуррамлик	о
хурсанд	р,с
хурсандлик	о
хурсандчилик	о
хуруж	о
хуруш	о
хурушламоқ	ф
хур-хур	т
хуршид	о
хусумат	о
хусуматли	с
хусус	о
хусусан	р
хусусида	к
хусусий	с
хусусийлаштириш	о
хусусийлик	о
хусусият	о
хутба	о
хутор	о
хуфиёна	р,с
хуфия	с
хуфияки	с
хуфтон	о
хуфя	о
хуш	с
хушатвор	с
хушахлоқ	с
хушбахт	с
хушбахтлик	о
хушбаҳра	с
хушбаҳралик	о
хушбичим	с
хушбичимлик	о
хушбўй	с
хушвақт	с
хушвақтлик	о
хушгап	с
хушдил	с
хушёқмас	о
хушёқмаслик	о
хушичим	с
хушкайф	с
хушламоқ	ф
хушлашмоқ	ф
хушлуқум	с
хушманзара	с
хушманзаралик	о
хушмулозим	с
хушмулозимат	о
хушмулозиматлик	о
хушмуомала	с
хушммуомалалик	о
хушмўйлов	с
хушнаво	с
хушнуд	с
хушнудлик	о
хушовоз	с
хушомад	о
хушомадгўй	о
хушомадгўйлик	о
хушомадомуз	р
хушоҳанг	с
хушрўй	с,р,о
хушрўйлик	о
хушсурат	с
хушсухан	с
хушсуҳбат	с
хуштабассум	с
хуштабиат	с
хуштабиатли	с
хуштабиатлик	о
хуштавозе	с
хуштакаллуф	с
хуштакаллуфлик	о
хуштакаллуфлилик	о
хуштаъб	с
хуштаъм	с
хуштаъмлик	о
хуштор	о
хушторлик	о
хушфеъл	с
хушфеъллик	о
хушхабар	о
хушхандон	р
хушхат	о,с
хушхон	с
хушхонлик	о
хушхулқ	с
хушхулқлик	о
хушхўр	с
хушчақчақ	с
хушчақчақлик	о
хушқад	с
хушқомат	с
хушҳаво	с
хушҳид	с
хушҳол	с
хўб	с,р,о
хўжа	о
хўжабека	о
хўжазода	о
хўжайин	о
хўжайинлик	о
хўжалик	о
хўжалик	о
хўжасавдогар	о
хўжасизларча	р
хўжасизлик	о
хўжағат	о
хўмраймоқ	ф
хўп	ю,р
хўппа	с
хўптир	о
хўп-хўп	ю
хўр	о
хўра	с
хўрак	о
хўраки	с
хўракхона	о
хўрам-нохўрам	р
хўранда	о
хўрда	о,с
хўрилламоқ	ф
хўриллатмоқ	ф
хўрламоқ	ф
хўрлик	о
хўроз	о
хўрозбоз	о
хўрозланмоқ	ф
хўрозқанд	о
хўрсиниқ	о
хўрсинмоқ	ф
хўр-хўр	т
хўтик	о
хўш	ю
хўшламоқ	ф
хўқача	о
