цанга	о
цапфа	о
цедра	о
цезий	о
цейтнот	о
целлофан	о
целлулоид	о
целлюлоза	о
цельсий	о
цемент	о,с
цементламоқ	ф
ценз	о
цензор	о
цензура	о
цент	о
центнер	о
центнерли	с
центнерчи	о
централизм	о
центризм	о
центрист	о
центрифуга	о
церий	о
цесарка	о
цех	о
циан	о
цианли	с
цивилизация	о
цигара	о
цикл	о
циклик	с
цикллаштирмоқ	ф
циклли	с
циклон	о
циклотрон	о
цилиндр	о
цилиндрик	с
цилиндрли	с
цинга	о
цинк	о
цинкограф	о
цинкография	о
цирк	о
цирконий	о
циркуль	о
циркуляр	о
циркчи	о
цирроз	о
цистерна	о
цистернали	с
цистит	о
цитата	о
цитатабозлик	о
цитодиагностика	о
цитокимё	о
цитолиз	о
цитология	о
цитрус	о
циферблат	о
циферблатли	с
цоколь	о
цунами	о
