ў	у
ўббў	у
ўбдан	р
ўгай	с
ўгайламоқ	ф
ўгайлик	о
ўгириғлиқ	ф
ўгирма	о
ўгирмоқ	ф
ўгит	о
ўгитламоқ	ф
ўдаға	о
ўдағайланмоқ	ф
ўжар	с
ўжарлик	о
ўжарона	р
ўжарчасига	р
ўз	ол
ўзак	о
ўзан	о
ўзаро	с,р
ўзағон	с
ўзбек	о
ўзбеклар	о
ўзбеклик	о
ўзбекча	р,с
ўзбекчаламоқ	ф
ўзбекчалаштирмоқ	ф
ўзбекчасига	р
ўзбекчилик	о
ўзбилармон	о
ўзбилармонлик	о
ўзбошимча	с
ўзбошимчалик	о
ўзга	о
ўзгалик	о
ўзгариш	о
ўзгаришсиз	р
ўзгармас	с
ўзгармоқ	ф
ўзгарувчан	с
ўзгарувчанлик	о
ўзгача	с,р
ўзибўларчилик	о	
ўзидан-ўзи	р
ўзича	р
ўзишмачоқ	о
ўзиюрар	с
ўзлашма	с
ўзлашмоқ	ф
ўзлаштирма	с
ўзлаштирмовчи	о
ўзлаштирмоқ	ф
ўзлик	о
ўзмоқ	ф
ўзоғ	с
ўзоғи	с
ўз-ўзига	ол
ўз-ўзидан	р
ўзғир	с
ўй	о
ўйдим-чуқур	с
ўйқир-қўнқир	с
ўйин	о
ўйинбоз	о
ўйинбузуқи	о
ўйин-кулги	о
ўйин-мазах	о
ўйинхона	о
ўйинчи	о
ўйинчиқ	о
ўйинчоқ	о
ўйинқароқ	с
ўйинқароқлик	о
ўйиқ	о
ўйламоқ	ф
ўйламсирамоқ	ф
ўйланмоқ	ф
ўйли	с
ўйма	с
ўймакор	о
ўймакорлик	о
ўймаламоқ	ф
ўймоқ	ф,о
ўйнамоқ	ф
ўйнаш	ф
ўйнашлик	о
ўйнашмоқ	ф
ўйноқ	с
ўйноқи	с
ўйноқламоқ	ф
ўйпараст	с
ўйчан	с
ўйчанлик	о
ўйчи	о
ўкил	о
ўкин	о
ўкиниш	ф
ўкинмоқ	ф
ўкинч	о
ўкинчли	с
ўкирик	о
ўкирмоқ	ф
ўкрамоқ	ф
ўкранмоқ	ф
ўксиз	с
ўксизланмоқ	ф
ўксик	с,о
ўксиклик	о
ўксимоқ	ф
ўксинмоқ	ф
ўктам	с
ўктамлик	о
ўкча	о
ўкчали	с
ўл-а	у
ўлай	у
ўлакса	о
ўлаксахўр	о
ўламса	о
ўлан	о
ўланзор	о
ўланчи	о
ўлардай	с
ўлармон	с
ўлармонлик	о
ўлароқ	б
ўларча	с
ўласи	о
ўлат	о
ўлганда	р
ўлгудай	р
ўлгундай	р
ўлгунча	р
ўлжа-жўлда	р
ўлжа	о
ўлиб-нетиб	ф
ўлиб-тирилиб	р
ўлик	ф,о
ўликхона	о
ўлим	о
ўлим-йитим	о
ўлимлик	о
ўлимнома	о
ўлимса	о
ўлимсахўр	о
ўлимтик	о,с
ўлимтиклик	о
ўлимтикхўр	о
ўлка	о
ўлкашунос	о
ўлкашунослик	о
ўлмас	ф
ўлмоқ	ф
ўлпон	о
ўлпончи	о
ўлтанг	о
ўлтириш	о
ўлтирмоқ	ф
ўлчагич	о
ўлчак	о
ўлчам	о
ўлчамли	с
ўлчамоқ	ф
ўлчов	о
ўлчовли	с
ўлчовсиз	с
ўлчоғли	с
ўмармоқ	ф
ўмбаламоқ	ф
ўмбалоқ	о
ўмбоқ-дўмбоқ	с
ўмгак	о
ўмган	о
ўмганламоқ	ф
ўмиз	о
ўмилдириқ	о
ўмров	о
ўмровдор	с
ўмровламоқ	ф
ўмровли	с
ўн	сн
ўнақай	с
ўнбоши	о
ўнбошилик	о
ўнг	с,о
ўнграмоқ	ф
ўнгимоқ	ф
ўнгир	о
ўнгламоқ	ф
ўнгмоқ	ф
ўнг-сўл	о
ўнг-терс	о
ўнгчилик	о
ўнлар	о
ўнли	с
ўнлик	о
ўнталик	с
ўнқир	о
ўнқир-чўнқир	с
ўнқир-чўнқирлик	о
ўнқов	о
ўнғай	с
ўнғайлашмоқ	ф
ўнғайлик	о
ўнғайсиз	с
ўнғайсизланмоқ	ф
ўнғайсизлик	о
ўнғалмас	с
ўнғармоқ	ф
ўпирилиш	ф
ўпирилмоқ	ф
ўпирма	о
ўпирмоқ	ф
ўпич	о
ўпиш	ф
ўпишмоқ	ф
ўпка	о
ўпка-гина	о
ўпкаламоқ	ф
ўпкали	с
ўпкасиз	с
ўпкачи	с
ўпмоқ	ф
ўпоқ	с
ўпоқ-сўпоқ	с
ўпқин	о
ўпқинлик	о
ўпқон	о
ўпқонлик	о
ўр	о,с
ўра	о
ўраб-чирмаб	р
ўраламоқ	ф
ўралашмоқ	ф
ўралишмоқ	ф
ўралмоқ	ф
ўрам	о
ўрама	с,о
ўрамаламоқ	ф
ўрамламоқ	ф
ўрамоқ	ф
ўрашмоқ	ф
ўргамчи	о
ўргачилик	с
ўрганиш	ф
ўрганмоқ	ф
ўргатмоқ	ф
ўргилмоқ	ф
ўргимчак	о
ўргимчаккана	о
ўрда	о
ўрдак	о
ўрдалик	о
ўрду	о
ўрдугоҳ	о
ўрик	о
ўрикзор	о
ўрикфуруш	о
ўрим	о
ўрим-йиғим	о
ўрин	о
ўринбосар	о
ўриндиқ	о
ўриндиқли	с
ўриндош	о
ўриндошлик	о
ўринламоқ	ф
ўринлатмоқ	ф
ўринлашмоқ	ф
ўринли	с
ўринсиз	с,р
ўрис	о
ўрисча	о
ўриш	ф
ўркач	о
ўркачдор	с
ўркачланмоқ	ф
ўркачли	с
ўрламоқ	ф
ўрлик	о
ўрма	с
ўрмак	о
ўрмаламоқ	ф
ўрмон	о
ўрмонзор	о
ўрмонли	с
ўрмонлик	о
ўрмончилик	о
ўрмоншунос	о
ўрмоншунослик	о
ўрмоқ	ф
ўрнак	о
ўрнакли	с
ўрнамоқ	ф
ўрнатмоқ	ф
ўрнашмоқ	ф
ўров	о
ўрол	о
ўроқ	о
ўроқ-болға	о
ўроқчи	о
ўроқчилик	о
ўроғлиқ	с
ўрп	о
ўрт	о
ўрта	о,с
ўртаасрчилик	о
ўртакаш	о
ўрталик	о
ўртамиёна	с
ўртамоқ	ф
ўртанча	с
ўртапишар	с
ўртача	с
ўртаҳол	с
ўртоқ	о
ўртоқлашмоқ	ф
ўртоқлик	о
ўртоқчилик	о
ўр-қир	о
ўсал	о
ўсаллашмоқ	ф
ўсаллик	о
ўсим	о
ўсимлик	о
ўсимликшунос	о
ўсимликшунослик	о
ўсимта	о
ўсиш	ф,о
ўсиқ	с
ўсиқча	о
ўсма	о
ўсмали	с
ўсмир	о
ўсмирлик	о
ўсмоқ	ф
ўсмоқламоқ	ф
ўсмоқчиламоқ	ф
ўспирин	о
ўспиринлик	о
ўсувчан	с
ўсувчанлик	о
ўт	о
ўта	р,ф
ўтака	о
ўтакетган	с
ўтамоқ	ф
ўтар	ф,о
ўтган	ф
ўтзор	о
ўтимли	с
ўтимсиз	с
ўтин	о
ўтинкаш	о
ўтинкашлик	о
ўтинмоқ	ф
ўтинфуруш	о
ўтунхона	о
ўтинч	о
ўтинчи	о
ўтиргич	о
ўтирик	с,р
ўтирикчи	о
ўтириш	ф,о
ўтирмоқ	ф
ўтказгич	о
ўтказмоқ	ф
ўтказувчан	с
ўтказувчанлик	о
ўткармоқ	ф
ўткизмоқ	ф
ўткинчи	о,с
ўткир	с
ўткирламоқ	ф
ўткирлашмоқ	ф
ўткирлик	о
ўтламоқ	ф
ўтли	с
ўтли-шудли	с
ўтлов	о
ўтлоқ	о
ўтмас	с
ўтмасланмоқ	ф
ўтмаслашмоқ	ф
ўтмиш	о
ўтмишдош	о
ўтмоқ	ф
ўтов	о
ўт-олов	о
ўтомоч	о
ўтоқ	о,с
ўтоқчи	о
ўтоғаси	о
ўтпараст	о
ўтпарастлик	о
ўтрик	с
ўтроқ	с
ўтроқлашмоқ	ф
ўтроқлик	о
ўтру	о
ўтрук	с,р
ўтрукчи	о
ўтсочар	о
ўттиз	сн
ўтхона	о
ўтхўр	с
ўт-ўлан	о
ўтқазмоқ	ф
ўхчимоқ	ф
ўхчиқ	о
ўхшалмоқ	ф
ўхшамаган	ф,с
ўхшамоқ	ф
ўхшатиш	ф,о
ўхшатма	ф,о
ўхшатмоқ	ф
ўхшаш	ф,с
ўхшашлик	о
ўхшашсиз	р
ўхшовсиз	с
ўч	о,с
ўчакиш	о
ўчакишгандай	р
ўчакишгандек	р
ўчакишмоқ	ф
ўчинқирамоқ	ф
ўчиргич	о
ўчиқ	с
ўчлик	о
ўчмоқ	ф
ўчоқ	о
ўчоқбоши	о
ўша	ол
ўшал	ол
ўшанақа	с
ўшанақанги	с
ўшанақаси	р
ўшандай	с
ўшандайича	р
ўшандайлигича	р
ўшанча	р
ўшанчалик	р
ўша-ўша	р
ўшшаймоқ	ф
ўшқирмоқ	ф
ўювчи	ф
ўқ	о
ўқалоқ	о
ўқалоқламоқ	ф
ўқариқ	о
ўқдай	с
ўқдек	с
ўқдон	о
ўқ-дори	о
ўқ-ёй	о
ўқиган	ф
ўқилон	о
ўқимаган	ф
ўқимишли	с
ўқимоқ	ф
ўқитмоқ	ф
ўқитувчи	о
ўқитувчилик	о
ўқиш	ф,о
ўқиш-ёзиш	о
ўқламоқ	ф
ўқли	с
ўқлов	о
ўқлоқ	о
ўқлоғи	о
ўқра	о
ўқраймоқ	ф
ўқранмоқ	ф
ўқсочар	о
ўқталмоқ	ф
ўқтамоқ	ф
ўқтин-ўқтин	р
ўқув	ф,с
ўқувчи	о
ўқчи	о
ўқчимоқ	ф
ўғил	о
ўғилли	с
ўғиллик	о
ўғилсиз	с
ўғилсизлик	о
ўғил-қиз	о
ўғир	о
ўғирламоқ	ф
ўғирлиқ	с
ўғирлиқча	р
ўғит	о
ўғитлагич	о
ўғитламоқ	ф
ўғлон	о
ўғон	о
ўғри	о
ўғрибоши	о
ўғривачча	о
ўғрилик	о
ўғринча	р
ўғринчасига	р
ўғринчи	р
ўғрихона	о
ўғуз	о
ўҳ	у
ўҳў	у,т
ўҳҳў	у
