ҳа	ю
ҳаб	о
ҳабада	с
ҳабата	с
ҳабаш	о
ҳабашбашара	с
ҳабашлар	о
ҳабба	ю
ҳабиб	о
ҳабо	о
ҳабс	о
ҳабсхона	о
ҳавас	о
ҳавасак	c
ҳавасаки	с
ҳаваскор	о
ҳаваскорлик	о
ҳавасланмоқ	ф
ҳавасли	с
ҳавасманд	с
ҳавз	о
ҳавза	о
ҳаво	о
ҳаводор	с,о
ҳавоза	о
ҳавойи	с
ҳавойиланмоқ	ф
ҳавойилашмоқ	ф
ҳавойилик	о
ҳавол	с
ҳавола	о
ҳаволамоқ	ф
ҳаволанмоқ	ф
ҳаволатмоқ	ф
ҳаволи	с
ҳаволланмоқ	ф
ҳавон	о
ҳавонча	о
ҳаворий	о
ҳавсала	о
ҳад	о
ҳадд	о
ҳадаф	о
ҳадаҳа	р
ҳаддили	с
ҳадеб	р
ҳадеганда	р
ҳадемай	р
ҳадик	о
ҳадикланмоқ	ф
ҳадикли	с
ҳадиксиз	с
ҳадиксирамоқ	ф
ҳадикчи	о
ҳадис	о
ҳадисшунослик	о
ҳадсиз	с
ҳадя	о
ҳаё	о
ҳаёли	с
ҳаён	о
ҳаёсиз	с
ҳаёсизлашмоқ	ф
ҳаёсизлик	о
ҳаёт	о
ҳаётбахш	с
ҳаётий	с
ҳаётийлик	о
ҳаёт-мамот	о
ҳаётчан	с
ҳаж	о
ҳажв	о
ҳажвиёт	о
ҳажвий	с
ҳажвия	о
ҳажвчи	о
ҳажвчилик	о
ҳажиқиз	о
ҳажм	о
ҳажман	р
ҳажмий	с
ҳажмли	с
ҳажр	о
ҳаз	о
ҳазар	о
ҳазарланмоқ	ф
ҳазил	о
ҳазилакам	с
ҳазилакамига	р
ҳазилвон	с
ҳазилвонлик	о
ҳазилкаш	с
ҳазилкашлик	о
ҳазилламоқ	ф
ҳазиллашмоқ	ф
ҳазилнамо	с
ҳазиломуз	с
ҳазилсимон	с
ҳазин	с
ҳазиният	о
ҳазинлик	о
ҳазир	с
ҳазм	о
ҳазмламоқ	ф
ҳазмли	с
ҳазор	сн
ҳазор-баҳазор	сн
ҳазорон	сн
ҳазрат	о
ҳай	у
ҳайбаракалла	о
ҳайбаракаллачи	о
ҳайбаракаллачилик	о
ҳайбат	о
ҳайбатли	с
ҳайвон	о
ҳайвонзот	о
ҳайвоний	с
ҳайвонлашмоқ	ф
ҳайвонлик	о
ҳайвонот	о
ҳайдалма	с
ҳайдамоқ	ф
ҳайдар	о,с
ҳайдаркокил	о
ҳайдовчи	ф
ҳайдовчилик	о
ҳайё-ҳай	у
ҳайё-ҳу	у
ҳайё-ҳуйт	у
ҳайз	о
ҳайинчак	о
ҳайинчалак	о
ҳайит	о
ҳайитламоқ	ф
ҳайитлашмоқ	ф
ҳайитлик	о
ҳайит-маърака	о
ҳайитчилик	о
ҳайиқишмоқ	ф
ҳайиқмоқ	ф
ҳайкал	о
ҳайкалак	о
ҳайкаллашмоқ	ф
ҳайкалтарош	о
ҳайкалтарошлик	о
ҳайкалчи	о
ҳайрат	о
ҳайратангиз	р
ҳайратбахш	с
ҳайратланмоқ	ф
ҳайратли	с
ҳайратомуз	с
ҳайрон	р,с
ҳайрона	р,с
ҳайронлик	о
ҳайт	у
ҳайтовур	м
ҳайто-ҳайт	т
ҳайт-ҳуйт	т
ҳайф	у
ҳайфки	у
ҳайфким	у
ҳайфсан	о
ҳайфсинмоқ	ф
ҳайъат	о
ҳайқириқ	о
ҳайқирмоқ	ф
ҳайқироқ	о
ҳай-ҳай	у
ҳайҳайламоқ	ф
ҳайҳайлашмоқ	ф
ҳайҳот	у
ҳайҳотдай	с
ҳайҳотдек	с
ҳай-ҳув	у
ҳакалак	с
ҳакам	о
ҳакамлик	о
ҳакачакламоқ	ф
ҳакачаламоқ	ф
ҳакилламоқ	ф
ҳаким	о
ҳакима	о
ҳакимлик	о
ҳакка	о
ҳакка-дукка	с
ҳаккалак	о
ҳаккаламоқ	ф
ҳаккам-дукка	с
ҳаккар	с
ҳаккачакламоқ	ф
ҳаккаовламоқ	ф
ҳаккок	о
ҳакламоқ	ф
ҳал	с
ҳалак	р
ҳала-ҳула	сн
ҳалво	о
ҳалвогар	о
ҳалвойтар	о
ҳалдор	с
ҳали	р,ю
ҳали-бери	р	
ҳалига	р
ҳалигача	р
ҳалиги	ол
ҳалигидай	с,р
ҳалигидек	с,р
ҳалигидақа	с
ҳалидан-ҳали	р
ҳализамон	р
ҳалийдақа	с
ҳалим	с,о
ҳалимдай	с
ҳалимдек	с
ҳалимхона	о
ҳалинчак	о
ҳалитдан	р
ҳали-ҳали	р
ҳалламоқ	ф
ҳалли	с
ҳаллос	о
ҳаллосламоқ	ф
ҳаллослатмоқ	ф
ҳаловат	о
ҳаловатли	с
ҳаловатсиз	с
ҳаловатсизлик	о
ҳалок	о
ҳалокат	о
ҳалокатли	с
ҳалол	с
ҳалола	о
ҳалоли	о
ҳалолламоқ	ф
ҳалоллик	о
ҳалолхўр	о
ҳалп	о
ҳалп-залп	о
ҳалпилламоқ	ф
ҳалпинчоқ	о
ҳалп-ҳалп	т
ҳалфана	о
ҳалфаначи	о
ҳалқ	о
ҳалқа	о
ҳалқаламоқ	ф
ҳалқаланмоқ	ф
ҳалқали	с
ҳалқум	о
ҳам	б,ю
ҳама	ол
ҳамавақт	р
ҳамал	о
ҳамаср	с
ҳамбўйинса	с
ҳамгап	о
ҳамд	о
ҳамда	б
ҳамдам	о
ҳамдамлашмоқ	ф
ҳамдард	о
ҳамдардлашмоқ	ф
ҳамдардлик	о
ҳамдаст	о
ҳамдил	о
ҳамдуна	о
ҳамдўстлик	о
ҳамёза	о
ҳамён	о
ҳамёстиқ	о
ҳамётоқ	о
ҳамжинс	о
ҳамжиҳат	с
ҳамжиҳатлик	о
ҳамза	о
ҳамин	о
ҳамиша	р
ҳамишабаҳор	о
ҳамишаги	с
ҳамишагидай	р
ҳамишалик	с
ҳамият	о
ҳамиятли	с
ҳамиятсиз	с
ҳамкасаба	о
ҳамкасб	о
ҳамкор	о
ҳамкорлик	о
ҳамкурс	о
ҳамл	о
ҳамла	о
ҳамма	ол
ҳаммабоп	с
ҳаммактаб	с
ҳаммаслак	о
ҳаммаҳалла	о
ҳаммиллат	о
ҳаммол	о
ҳаммоллик	о
ҳаммолчилик	о
ҳаммом	о
ҳаммомчи	о
ҳаммуаллиф	о
ҳаммуаллифлик	о
ҳамнафас	о
ҳамнафаслик	о
ҳамнишин	о
ҳамовоз	с
ҳамойил	о
ҳамон	р,к
ҳамоно	к
ҳамоқат	о
ҳамоҳанг	р
ҳампо	о
ҳампой	о
ҳамполик	о
ҳамранг	с
ҳамроз	о
ҳамроҳ	о
ҳамроҳлик	о
ҳамсафар	о
ҳамсинф	о
ҳамсоя	о
ҳамсоячилик	о
ҳамсуҳбат	о
ҳамтовоқ	о
ҳамфикр	о
ҳамхона	о
ҳамшаҳар	о
ҳамшира	о
ҳамширалик	о
ҳамшиша	о
ҳамюрт	о
ҳамқишлоқ	о
ҳамқур	о
ҳамҳужра	о
ҳангама	о
ҳанги	о
ҳанг-манг	р
ҳанг-манглик	о
ҳангом	о
ҳангома	о
ҳангомалашмоқ	ф
ҳангоматалаб	с
ҳанграмоқ	ф
ҳандалак	о
ҳандаса	о
ҳандасавий	с
ҳаник	о
ҳаннот	о
ҳансирамоқ	ф
ҳансиратмоқ	ф
ҳансироқ	о
ҳануз	р
ҳанузгача	р
ҳап	т,у
ҳапиллатмоқ	ф
ҳапинмоқ	ф
ҳаприқмоқ	ф
ҳапқат	с
ҳап-ҳап	т
ҳар	б
ҳаракат	о
ҳаракатланмоқ	ф
ҳаракатлантирмоқ	ф
ҳаракатли	с
ҳаракатсиз	с
ҳаракатчан	с
ҳарала-тарала	о
ҳарам	о
ҳарамхона	о
ҳарб	о
ҳарба	о
ҳарб-зарб	о
ҳарбий	с
ҳарбийлаштирмоқ	ф
ҳарбийлик	о
ҳарбийча	р,с
ҳарбийчасига	р
ҳарвона	о
ҳаргиз	ю
ҳардамхаёл	с
ҳардамхаёллик	о
ҳарина	с
ҳарир	о
ҳарис	с
ҳарислик	о
ҳариф	о
ҳарна	б
ҳарнечук	б
ҳаром	с,о
ҳаромзода	о
ҳароми	о
ҳаромламоқ	ф
ҳаромлик	о
ҳароммағиз	о
ҳаромнамак	о
ҳаромтовоқ	с
ҳаромтомоқ	с
ҳаромхўр	с
ҳаромхўрлик	о
ҳаром-ҳариш	о
ҳарорат	о
ҳароратли	с
ҳароратсиз	с
ҳарсилламоқ	ф
ҳарс-ҳарс	т
ҳартугул	м
ҳарф	о
ҳарфий	с
ҳарфма-ҳарф	р
ҳарфхўр	о
ҳарфхўрлик	о
ҳарчанд	б
ҳарчи	м
ҳасад	о
ҳасадгўй	о
ҳасадланмоқ	ф
ҳасадли	с,р
ҳасадчи	о
ҳасайни	о
ҳасана	о
ҳасанот	о
ҳасип	о
ҳасипфуруш	о
ҳасрат	о
ҳасратланмоқ	ф
ҳасратлашмоқ	ф
ҳасратли	с
ҳасрато	у
ҳасса	о
ҳассакаш	о
ҳассос	с
ҳасти	о
ҳатламоқ	ф
ҳатто	ю
ҳаттоки	ю
ҳафранг	с
ҳафсала	о
ҳафсалали	с
ҳафсаласиз	с
ҳафта	о
ҳафталаб	р
ҳафталик	с,о
ҳафтафаҳм	с
ҳафтияк	о
ҳафтранг	с
ҳачча	о
ҳашам	о
ҳашамат	о
ҳашаматли	с
ҳашамдор	с
ҳашамсиз	с
ҳашар	о
ҳашарот	о
ҳашаротхўр	с
ҳашарчи	о
ҳаш-паш	т
ҳаштак	о
ҳаштияк	о
ҳаяжон	о
ҳаяжонланмоқ	ф
ҳаяжонли	с
ҳаял	сн
ҳаялламоқ	ф
ҳақ	с,о
ҳаққ	с,о
ҳақгўй	о
ҳақгўйлик	о
ҳақда	к
ҳақдор	с
ҳақир	с
ҳақирлик	о
ҳақиқ	о,с
ҳақиқат	о
ҳақиқатан	р
ҳақиқатгўй	о
ҳақиқатда	р
ҳақиқатпараст	о
ҳақиқатпарвар	о
ҳақиқатсизлик	о
ҳақиқатчи	с
ҳақиқий	с
ҳақламоқ	ф
ҳақли	с
ҳақорат	о
ҳақоратламоқ	ф
ҳақоратланмоқ	ф
ҳақоратли	с
ҳақоратомуз	с
ҳақпараст	о
ҳақраҳа	о
ҳақрост	м
ҳақсевар	с
ҳақсиз	с,р
ҳақсизлик	о
ҳаққаст	о
ҳаққоний	с
ҳаққонийлик	о
ҳаққоният	о
ҳаққув	о
ҳаққуш	о
ҳаҳ	у
ҳа-ҳа	у
ҳаҳаламоқ	ф
ҳаҳачи	о
ҳаҳа-ҳаҳа	у
ҳа-ҳу	т
ҳаҳҳа	у
ҳе	у
ҳез	о
ҳезалак	о
ҳезалакчалиш	с
ҳезимкаш	о
ҳезумкаш	о
ҳей	у
ҳемири	о
ҳемирилик	о
ҳемирича	о
ҳеч	ю
ҳечқиси	о
ҳечқурса	м
ҳеҳ	у
ҳе-ҳа	у
ҳе-ҳе-ҳе	т
ҳеҳ-ҳа	у
ҳеҳ-ҳе	у
ҳибс	о
ҳибсхона	о
ҳид	о
ҳиддат	о
ҳиддатланмоқ	ф
ҳидламоқ	ф
ҳидланмоқ	ф
ҳидли	с
ҳидоят	о
ҳидсиз	с
ҳижжаламоқ	ф
ҳижо	о
ҳижоб	о
ҳижоламоқ	ф
ҳижоли	с
ҳижра	о
ҳижрий	с
ҳижрия	с
ҳижрон	о
ҳижронзада	с
ҳийла	о
ҳийлагар	о
ҳийлагарлик	о
ҳийлакор	о
ҳийлакорлик	о
ҳийлакорона	р
ҳийлали	с
ҳийла-макр	о
ҳийла-найранг	о
ҳийласиз	с
ҳийлачи	о
ҳикмат	о
ҳикматли	с
ҳикматомуз	с
ҳикоя	о
ҳикоянавис	о
ҳикоянавислик	о
ҳикоят	о
ҳикоячи	о
ҳикоячилик	о
ҳилва	с
ҳилвилламоқ	ф
ҳилвирамоқ	ф
ҳилла	о
ҳилол	о
ҳилпилламоқ	ф
ҳилпирамоқ	ф
ҳилпиратмоқ	ф
ҳилп-ҳилп	т
ҳил-ҳил	т
ҳим	у
ҳимармоқ	ф
ҳимм	у
ҳиммат	о
ҳимматли	с
ҳимматсиз	с
ҳимо	о
ҳимоя	о
ҳимоясиз	с
ҳимоят	о
ҳимоятли	с
ҳимоячи	о
ҳингилламоқ	ф
ҳингиллашмоқ	ф
ҳингир-ҳингир	т
ҳинд	о
ҳинди	о
ҳиндий	о
ҳиндлар	о
ҳиндулар	о
ҳиндча	с
ҳирингламоқ	ф
ҳиринг-ҳиринг	т
ҳировул	о
ҳирс	о
ҳирсий	с
ҳирсли	с
ҳис	о
ҳисс	о
ҳисламоқ	ф
ҳисли	с
ҳисоб	о
ҳисобда	с
ҳисобдон	с
ҳисобдор	с
ҳисоб-китоб	о
ҳисобламоқ	ф
ҳисобланмоқ	ф
ҳисоблаш	ф
ҳисоблашмоқ	ф
ҳисобли	с
ҳисобот	о
ҳисобсиз	с
ҳисобчи	о
ҳисобчилик	о
ҳисори	с
ҳисорий	с
ҳисса	о
ҳиссадор	о
ҳиссиёт	о
ҳиссиётли	с
ҳиссиётчи	о
ҳиссий	с
ҳиссиз	с
ҳис-туйғу	о
ҳифз	о
ҳиқ	т
ҳиқилдоқ	о
ҳиқилламоқ	ф
ҳиқичоқ	о
ҳи-ҳи	т
ҳиҳиламоқ	ф
ҳмм	у
ҳо	у,о
ҳов	у
ҳовва	м
ҳовли	о
ҳовли-жой	о
ҳовлиқма	с
ҳовлиқмалик	о
ҳовлиқмачи	о
ҳовлиқмоқ	ф
ҳовонча		о
ҳовр	о
ҳовриқмоқ	ф
ҳовуз	о
ҳовузча	о
ҳовулламоқ	ф
ҳовур	о
ҳовурли	с
ҳовуч	о
ҳовучлаб	р
ҳодис	ю
ҳодиса	о
ҳожат	о
ҳожатбарор	с
ҳожатбарорлик	о
ҳожатманд	о
ҳожатраво	о
ҳожатхона	о
ҳожи	о
ҳожиб	о
ҳожидўппи	о
ҳожихона	о
ҳозир	р,с
ҳозиргача	р
ҳозирги	с
ҳозиргидай	р
ҳозирдан	р
ҳозиржавоб	с
ҳозиржавоблик	о
ҳозирламоқ	ф
ҳозирланмоқ	ф
ҳозирлик	о
ҳозирча	р
ҳозирчалик	р
ҳозиқ	с
ҳой	у
ҳойнаҳой	м
ҳойҳойламоқ	ф
ҳой-ҳуй	у
ҳойҳуйламоқ	ф
ҳоказо	ол
ҳоким	о
ҳокимият	о
ҳокимлик	о,с
ҳокимона	р
ҳол	о
ҳоланки	у
ҳолат	о
ҳол-аҳвол	о
ҳол-бақудрат	р
ҳоли-бақудрат	р
ҳолбуки	б
ҳолва	о
ҳолвагар	о
ҳолвайтар	о
ҳолвапаз	о
ҳолвафуруш	о
ҳолвачи	о
ҳол-жон	о
ҳолсиз	р,с
ҳолсизланмоқ	ф
ҳолсизлик	о
ҳол-қудрат	р
ҳомиз	о
ҳомий	о
ҳомийлик	о
ҳомийсиз	с
ҳомила	о
ҳомиладор	с
ҳомиладорлик	о
ҳомилали	с
ҳомуза	о
ҳопитмоқ	ф
ҳордиқ	о
ҳордиқхона	о
ҳориб-толиб	р
ҳориб-чарчаб	р
ҳоримоқ	ф
ҳорма	у
ҳорманг	у
ҳормоқ	ф
ҳорғин	с
ҳорғинлик	о
ҳосид	о
ҳосил	о
ҳосила	о
ҳосилдор	с
ҳосилдорлик	о
ҳосилли	с
ҳосилот	о
ҳосилотлик	о
ҳосилотхона	о
ҳосилсиз	с
ҳотам	о
ҳотамлик	о
ҳотамтой	о
ҳотамтойлик	о
ҳофиз	о
ҳофиза	о
ҳошия	о
ҳошияламоқ	ф
ҳошияли	с
ҳошо	м
ҳо-ҳо	у
ҳу	у,т
ҳуббулмалик	о
ҳув	у
ҳувайдо	о
ҳувулламоқ	ф
ҳувуллатмоқ	ф
ҳув-ҳув	у
ҳувҳувламоқ	ф
ҳуда-беҳуда	р
ҳуда-беҳудага	р
ҳудайчи	о
ҳудуд	о
ҳудудсиз	с
ҳудҳуд	о
ҳужайра	о
ҳужайравий	с
ҳужайрали	с
ҳужжат	о
ҳужжатламоқ	ф
ҳужжатлаштирмоқ	ф
ҳужжатли	с
ҳужжатчи	о
ҳужжатчилик	о
ҳужра	о
ҳужрабазм	о
ҳужрадор	о
ҳужрадош	о
ҳужум	о
ҳужумкор	с
ҳужумкорлик	о
ҳужумчи	о
ҳузн	о
ҳузнли	с
ҳузур	о
ҳузурбахш	с
ҳузурланмоқ	ф
ҳузур-ҳаловат	о
ҳуйт	у
ҳуйтҳуйтламоқ	ф
ҳуйя	о
ҳуйя-ҳуй	о
ҳукамо		о
ҳукм	о
ҳукмдор	о
ҳукмдорлик	о
ҳукмикуш	о
ҳукмнома	о
ҳукмрон	о
ҳукмронлик	о
ҳукмфармо	о
ҳукумат	о
ҳукуматдор	о
ҳулкар	о
ҳулла	о
ҳумо	о
ҳумоюн	о
ҳунар	о
ҳунарбоз	с
ҳунарли	с
ҳунарманд	о
ҳунармандлик	о
ҳунармандчилик	о
ҳунарсиз	с
ҳур	с
ҳурилиқо	о
ҳуркагич	с,о
ҳуркак	с,о
ҳуркитмоқ	ф
ҳуркмоқ	ф
ҳурковуч	с,о
ҳурконғич	с,о
ҳурлик	о
ҳурлиқо	о
ҳурмат	о
ҳурматан	р
ҳурматламоқ	ф
ҳурматлаш	ф
ҳурматли	с
ҳурматсиз	с
ҳурматсизланмоқ	ф
ҳурматсизлик	о
ҳурматталаб	с
ҳурмоқ	ф
ҳурпаймоқ	ф
ҳурпайтирмоқ	ф
ҳурпак	с
ҳуррият	о
ҳурриятпарвар	с
ҳурриятчи	о
ҳусайни	о
ҳусн	о
ҳуснбузар	о
ҳусндор	с
ҳуснихат	о
ҳусния	с,о
ҳуснли	с
ҳуснсиз	с
ҳут	о
ҳут-ют	о
ҳуш	о
ҳушёр	с
ҳушёрланмоқ	ф
ҳушёрлик	о
ҳушёрхона	о
ҳушли	с
ҳушсиз	с,р
ҳушсизланмоқ	ф
ҳушсизларча	р
ҳушсизлик	о
ҳушт	у
ҳуштак	о
ҳуштакбоз	о
ҳуқна	о
ҳуқуқ	о
ҳуқуқбузар	о
ҳуқуқбузарлик	о
ҳуқуқий	с
ҳуқуқли	с
ҳуқуқсиз	с
ҳуқуқсизлик	о
ҳуқуқшунос	о
ҳуқуқшунослик	о
ҳуққа	о
ҳуққабоз	о,с
ҳуққабозлик	о
ҳуққи	о
ҳуҳ	у,т
ҳуҳламоқ	ф
ҳу-ҳу	т
ҳуҳуламоқ	ф
ҳў	ол
ҳўв	ол
ҳўй	у
ҳўкиз	о
ҳўкки	с
ҳўл	с
ҳўлламоқ	ф
ҳўнгилламоқ	ф
ҳўнгир-ҳўнгир	т
ҳўнграмоқ	ф
ҳўнг-ҳўнг	т
ҳўп	у
ҳўплам	о
ҳўпламоқ	ф
ҳўппак	о
ҳўппоз	о
ҳўшшаймоқ	ф
ҳў-ў-ў	у
